topic_EN,topic_IT,sentence_EN,evidence_label_EN,evidence_score_EN,stance_label_EN,sentence_IT_ht,evidence_label_ht,evidence_conf_ht,evidence_num_labelers_ht,evidence_accept_ht,evidence_reject_ht,stance_label_ht,stance_conf_ht,stance_num_labelers_ht,stance_pro_ht,stance_con_ht,sentence_IT_mt,evidence_label_mt,evidence_conf_mt,evidence_num_labelers_mt,evidence_accept_mt,evidence_reject_mt,stance_label_mt,stance_conf_mt,stance_num_labelers_mt,stance_pro_mt,stance_con_mt
Begging should be banned,L'elemosina dovrebbe essere vietata,Devkota connects the beggar with the divine as the ultimate fount of kindness and empathy: ,1,0.6,-1,Devkota unisce il mendicante con il divino come ultima fonte di gentilezza ed empatia:,0,0.706512064,10,3,7,-1,1,3,0,3,Devkota connette il beggar con il divino come ultima schifezza della gentilezza e dell'empatia: ,0,0.880333391,10,1,9,,,1,1,0
Begging should be banned,L'elemosina dovrebbe essere vietata,"Research completed by Human Rights Watch revealed that when begging hours are completed for the day children often do not have proper shelter, adequate food, or access to healthcare where they reside .",0,0.3,1,"Una ricerca condotta da Human Rights Watch ha rivelato che i bambini che praticano l'accattonaggio spesso non hanno un riparo adeguato, cibo adeguato o accesso all'assistenza sanitaria.",1,0.807927934,10,8,2,1,1,8,8,0,"La ricerca completata da Human Rights Watch ha rivelato che quando le ore di elemosina vengono completate per i bambini di giorno spesso non hanno un riparo adeguato, un cibo adeguato o l'accesso all'assistenza sanitaria dove risiedono.",1,0.625545528,11,7,4,1,1,7,7,0
Blood donation should be mandatory,La donazione di sangue dovrebbe essere obbligatoria,"The WHO encouraged all countries to highlight stories from people whose lives have been saved through blood donation, as a way of motivating regular blood donors to continue giving blood and people in good health who have never given blood, particularly young people, to begin doing so.  ",1,0.75,1,"l' OMS ha incoraggiato tutti i paesi di mettere in luce storie di persone la cui vita e' stata salvata da donazioni di sangue, per incoraggiare i donatori di sangue a continuare a donare e persone in buona salute che non ha mai donato, specialmente i giovani, a comiciare a farlo.",1,0.822195243,10,8,2,1,1,8,8,0,"L'Oms ha incoraggiato tutti i paesi a evidenziare le storie di persone le cui vite sono state salvate attraverso la donazione di sangue, come modo per motivare i donatori di sangue regolari a continuare a dare sangue e persone in buona salute che non hanno mai dato sangue, in particolare ai giovani, per iniziare a farlo.  ",1,0.801645442,10,8,2,1,1,8,8,0
Blood donation should be mandatory,La donazione di sangue dovrebbe essere obbligatoria,socialblood is a Facebook application that connects blood donors and recipients of the same blood type through Facebook.,0,0,0,socialblood è un'applicazione Facebook che collega i donatori di sangue e i riceventi dello stesso gruppo sanguigno tramite Facebook.,0,1,7,0,7,,,0,0,0,socialblood è un'applicazione di Facebook che connette i donatori di sangue e i destinatari dello stesso tipo sanguigno attraverso Facebook.,0,1,7,0,7,,,0,0,0
Child labor should be legalized,Il lavoro minorile dovrebbe essere legalizzato,"138 and 182 lead in the fight against child labour, while Nos.",0,0.444444444,-1,"138 e 182 sono in testa nella lotta al lavoro minorile, mentre i numeri",0,0.915862179,10,1,9,,,1,0,1,"138 e 182 portano la lotta contro il lavoro minorile, mentre Nos.",0,0.788101786,12,3,9,-1,1,3,1,2
Child labor should be legalized,Il lavoro minorile dovrebbe essere legalizzato,"He supported the use of child labor, and was in favor of high tariffs to protect domestic industry.",1,0.555555556,1,"ha sostenuto l'uso di lavoro infantile, e era in favore di alte tariffe per proteggere l'industria nazionale.",0,0.547816747,10,5,5,1,1,5,4,1,"Sosteneva l'uso del lavoro minorile, ed era favorevole ad alte tariffe per proteggere l'industria domestica.",1,0.641203034,10,6,4,1,1,6,6,0
Criticism of the Iraq War is justified,La critica della guerra in Iraq è giustificata,Irey attacked Murtha for his criticism of the Iraq war.,0,0.3,-1,Irey ha attaccato Murtha per le sue critiche alla guerra in Iraq.,0,0.653820355,10,5,5,,,5,0,5,Irey ha attaccato Murtha per le sue critiche alla guerra in Iraq.,0,0.558465541,10,5,5,,,5,1,4
Criticism of the Iraq War is justified,La critica della guerra in Iraq è giustificata,"Rieckhoff's book, Chasing Ghosts, is a scathing criticism of the Iraq War and President George Bush that was praised by most critics.",0,0.5,1,"il libro di Riekhoff, Inseguendo Fantasmi, e' una forte critica sulla guerra in Iraq e sul presidente Georgee Bush che e' stata osannata da molti critici",1,0.808065127,10,8,2,1,1,8,8,0,"Il libro di Rieckhoff, Caccia Fantasmi, è una critica truffa alla guerra in Iraq e al presidente George Bush elogiato dalla maggior parte dei critici.",1,0.786219552,10,8,2,1,1,8,4,4
Emergency contraception should be subsidized,La contraccezione di emergenza deve essere sovvenzionata,"""A study in the UK found that ""the shift towards greater promotion of emergency birth control appears to have (..) worsened the impact of STI rates since 2000."" .  ",1,0.6,-1,""" uno studio nel Regno Unito ha scoperto che il passo ad un maggiore controllo delle nascite di emergenza sembra aver (..) peggiorato l'impatto del tasso STI dal 2000""",0,0.64271272,10,4,6,-1,1,4,1,3,"""Uno studio nel Regno Unito ha scoperto che"" il passaggio verso una maggiore promozione del controllo delle nascite di emergenza sembra avere (..) peggiorato l'impatto dei tassi STI dal 2000 "".  ",1,0.559888914,10,6,4,,,6,1,5
Emergency contraception should be subsidized,La contraccezione di emergenza deve essere sovvenzionata,"A few different drugs were studied, with a focus on high-dose estrogens, and it was originally hoped that postcoital contraception would prove viable as an ongoing contraceptive method.",0,0.3,1,"Sono stati studiati pochi farmaci differenti, con particolare attenzione agli estrogeni ad alto dosaggio, e si sperava originariamente che la contraccezione post-coitale si sarebbe rivelata valida come metodo contraccettivo in corso.",0,0.923423051,10,1,9,,,1,1,0,"Sono stati studiati alcuni farmaci diversi, con un focus sugli estrogeni ad alte dosi, e si sperava originariamente che la contraccezione postconiugale si rivelasse praticabile come metodo contraccettivo in corso.",0,0.895641684,10,1,9,,,1,1,0
Flu vaccination should be mandatory,La vaccinazione antinfluenzale dovrebbe essere obbligatoria,"Various public health organizations, including the World Health Organization, have recommended that yearly influenza vaccination be routinely offered, particularly to people at risk of complications of influenza and those individuals who live with or care for high-risk individuals, including: ",1,0.9,1,"Diverse organizzazioni sanitarie pubbliche, tra cui l'Organizzazione Mondiale della Sanità, hanno raccomandato di offrire regolarmente la vaccinazione antinfluenzale annuale, in particolare alle persone a rischio di complicazioni dell'influenza e a quelle persone che vivono o si prendono cura di persone ad alto rischio, tra cui: ",1,0.58518777,10,6,4,1,1,6,6,0,"Varie organizzazioni sanitarie pubbliche, tra cui l'Organizzazione Mondiale della Sanità, hanno raccomandato che la vaccinazione antinfluenzale annuale sia abitualmente offerta, in particolare alle persone a rischio di complicanze dell'influenza e a coloro che vivono con o a cura di individui ad alto rischio, tra cui: ",1,0.54287647,10,6,4,1,1,6,6,0
Flu vaccination should be mandatory,La vaccinazione antinfluenzale dovrebbe essere obbligatoria,"Nevertheless, the CDC recommends that elderly adults get the flu vaccine because influenza infection is particularly dangerous in this population and vaccine provides at least a moderate level of immunity to the flu virus.",1,1,1,"tuttavia, il CDC raccomanda che gli anziani assumano il vaccino antinfluenzale perche' l'influenza e' paricolarmente pericolosa in questa popolazione e il vaccino assicura almeno un moderato livello di immunita' al virus influenzale.",1,0.905217495,10,9,1,1,1,9,9,0,"Ciononostante, il CDC raccomanda che gli adulti anziani ottenino il vaccino antinfluenzale perché l'infezione influenzale è particolarmente pericolosa in questa popolazione e il vaccino fornisce almeno un livello moderato di immunità al virus influenzale.",1,0.801645442,10,8,2,1,1,8,8,0
Force-feeding should be banned,L'alimentazione forzata deve essere vietata,"Former prisoner Fawzi al-Odah told the BBC in 2006 that force-feeding of hunger strikers in Guantanamo amounts to torture and the UN Human Rights Commission said it regards force-feeding at Guantanamo as a form of torture, a charge the US firmly has repeatedly denied.  ",1,1,1,"Nel 2006, l'ex detenuto Fawzi al-Odah ha dichiarato alla BBC che l'alimentazione forzata di chi attua lo sciopero della fame, esercitata a Guantanamo, equivale a una tortura. La Commissione per i diritti umani delle Nazioni Unite ha dichiarato di considerare l'alimentazione forzata a Guantanamo come una forma di tortura, un'accusa che gli Stati Uniti hanno fermamente negato più volte.",1,0.881657808,10,9,1,1,1,9,9,0,"L'ex prigioniero Fawzi al - Odah ha detto alla BBC nel 2006 che l'alimentazione forzata degli scioperanti della fame a Guantanamo ammonta a tortura e la Commissione per i diritti umani dell'ONU ha detto che considera l'alimentazione forzata a Guantanamo come una forma di tortura, una carica che gli Usa hanno fermamente ripetutamente negato.  ",1,0.897707378,10,9,1,1,1,9,9,0
Force-feeding should be banned,L'alimentazione forzata deve essere vietata,"The effects of force feeding have even been likened to ""sexual assault"" by some scholars like June Purvis (Professor of Sociology at Portsmouth University); who cites the ill treatment of women in the Suffragette movement.",1,1,1,gli effetti dell' alimentaione forzata e' paragonabile all' assalto sessuale secondo alcuni studiosi come June Purvis(professoressa di sociologia dell' universita' di Portsmouth); che cita il trattamento medico di donne del movimento delle Sufraggette.,1,1,7,7,0,1,1,7,7,0,"Gli effetti dell'alimentazione forzata sono stati addirittura paragonati a ""violenza sessuale"" da parte di alcuni studiosi come June Purvis (Professore di Sociologia alla Portsmouth University); che cita il maltrattamento delle donne nel movimento Suffragette.",1,1,7,7,0,1,1,7,7,0
Jury duty should not be mandatory,Il dovere della giuria non dovrebbe essere obbligatorio,"Indeed, the famous legal scholar Blackstone wrote in the 18th century that women were rightfully prohibited from jury service because of what he labeled the defect of sex, which made them incapable of the intelligent decision-making required for jury duty.",0,0.1,0,"Infatti, il famoso studioso di diritto Blackstone scrisse nel XVIII secolo che alle donne era giustamente proibito di far parte di una giuria a causa di quello che egli definiva il difetto del sesso, il che le rendeva incapaci di prendere decisioni intelligenti, necessarie per quel compito.",0,0.924096481,10,1,9,,,1,1,0,"Infatti, il famoso studioso legale Blackstone scrisse nel 18 secolo che le donne erano giustamente vietate al servizio della giuria a causa di ciò che etichettò il difetto del sesso, che li rendette incapaci del processo decisionale intelligente richiesto per il dovere della giuria.",0,1,7,0,7,,,0,0,0
Jury duty should not be mandatory,Il dovere della giuria non dovrebbe essere obbligatorio,She was part of the Commission on Justice in the 21st Century and the Co-chair of the Committee on Improving Jury Service.,0,0,0,faceva parte della Commissione di Giustizia nel 21esimo Secolo e la co-presidente del Comitato del Miglioramento del Servizio di giuria.,0,1,7,0,7,,,0,0,0,Ha fatto parte della Commissione Giustizia nel 21 Secolo e la Co-presidenza del Comitato per il miglioramento del servizio della giuria.,0,0.870918176,10,1,9,1,1,1,1,0
Minority groups should be protected,I gruppi di minoranza dovrebbero essere protetti,"Freedom House has reported, in July 2005, that some ethnic minorities have encountered discrimination in such areas as housing, education, and employment.",1,0.9,1,"Nel luglio 2005, Freedom House ha riferito che alcune minoranze etniche hanno subito discriminazioni in settori quali la casa, l'istruzione e l'occupazione.",1,1,7,7,0,1,1,7,7,0,"Freedom House ha riferito, a luglio 2005, che alcune minoranze etniche hanno incontrato discriminazioni in settori come l'edilizia, l'istruzione e l'occupazione.",1,0.682106985,10,7,3,1,1,7,7,0
Minority groups should be protected,I gruppi di minoranza dovrebbero essere protetti,"In 1999, President Bill Clinton appointed her to the Presidential Commission on the Advancement of Women and Minorities in Science, Engineering, and Technology.",0,0.181818182,0,"nel 1999, il presidente Bill Clinton la nomino' alla Commissione Presidenziale per l' avvanzamento delle donne e delle minoranze in scienza, ingegneria e tecnologia.",0,0.550740293,10,5,5,1,1,5,5,0,"Nel 1999, il presidente Bill Clinton la ha nominata alla Commissione presidenziale sul tema Advancement of Women and Minoranze in Science, Engineering and Technology.",0,0.71238884,10,3,7,,,3,3,0
Payday loans should be banned,I prestiti Payday dovrebbero essere vietati,""".. payday lending services extend small amounts of uncollateralized credit to high-risk borrowers, and provide loans to poor households when other financial institutions will not.",1,0.666666667,-1,"""... i servizi di anticipo sullo stipendio accordano piccoli importi di credito non garantito a mutuatari ad alto rischio, e forniscono prestiti alle famiglie povere quando altri istituti finanziari non lo fanno.",1,0.77044246,10,8,2,-1,1,8,1,7,""" .. i servizi di prestito di payday estendono piccole quantità di credito non collateralizzato ai mutuatari ad alto rischio, e forniscono prestiti alle famiglie povere quando altre istituzioni finanziarie non lo faranno.",1,0.857390576,13,11,2,-1,0.70184387,11,1,10
Payday loans should be banned,I prestiti Payday dovrebbero essere vietati,"Besides putting people into debt, payday loans can also help borrowers reduce their debts.",0,0.214285714,0,"oltre che indebitare la gente, i prestiti con anticipo sullo stipendio possono aiutare i debitori a ridurre i propri debiti",1,0.837197827,10,8,2,-1,0.70184387,8,3,5,"Oltre a mettere in debito le persone, i prestiti in busta paga possono anche aiutare i mutuatari a ridurre i loro debiti.",1,0.51774556,10,5,5,-1,1,5,0,5
The Euro should be abandoned,L'Euro dovrebbe essere abbandonato,"To Raw, Sir Lancelot's importance is that he embodies ""mainstream Euro representations of the African American experience - on the one hand he portrays the Caribbean as a holiday-maker's paradise, full of sunshine, sea and limitless pleasures; on the other hand it is also a place of great danger, wherein westerners are perpetually vulnerable to attack by unknown forces.""",0,0,0,"Per Raw, l'importanza di Sir Lancelot è che egli incarna ""le principali rappresentazioni europeiste dell'esperienza afroamericana - da un lato ritrae i Caraibi come un paradiso per i vacanzieri, pieno di sole, mare e piaceri senza limiti; dall'altro ne fa anche un luogo di grande pericolo, dove gli occidentali sono perennemente vulnerabili agli attacchi di forze sconosciute"".",0,1,7,0,7,,,0,0,0,"A Raw, l'importanza di Sir Lancelot è che incarna ""mainstream Euro rappresentazioni dell'esperienza afroamericana - da una parte ritrae i Caraibi come un paradiso di case - maker, pieno di sole, mare e illimitati piaceri; d'altra parte è anche un luogo di grande pericolo, in cui gli occidentali sono perpetuamente vulnerabili ad attaccare da forze sconosciute"".",0,1,7,0,7,,,0,0,0
The Euro should be abandoned,L'Euro dovrebbe essere abbandonato,"On a global level, there is evidence that the introduction of the euro has led to an integration in terms of investment in bond portfolios, with eurozone countries lending and borrowing more between each other than with other countries.",1,0.75,-1,"a livello globale, esiste una prova che l'introduzione dell'euro ha portato ad una integrazione in termini di investimenti nel bond obbligazionario, con gli stati dell' eurozona prestando e ottenendo prestiti di piu' uno con l'atro che con altri stati",1,0.816570643,10,8,2,-1,1,8,0,8,"A livello globale, c'è la prova che l'introduzione dell'euro ha portato ad un'integrazione in termini di investimenti in portafogli obbligazionari, con i Paesi dell'Eurozona che si prestano e prendono in prestito più tra di loro che con altri paesi.",1,1,7,7,0,-1,1,7,0,7
We should abandon Twitter,Dovremmo abbandonare Twitter,Some studies indicate that the use of Twitter can positively impact the number of times a scientific article is cited.,1,1,-1,Alcuni studi indicano che l'uso di Twitter può avere un impatto positivo sul numero di volte in cui viene citato un articolo scientifico.,1,0.801651353,10,8,2,-1,1,8,0,8,Alcuni studi indicano che l'uso di Twitter può influenzare positivamente il numero di volte in cui viene citato un articolo scientifico.,1,0.911597368,10,8,2,-1,1,8,1,7
We should abandon Twitter,Dovremmo abbandonare Twitter,"In the UK, a survey indicated that 17% of small British businesses were using Twitter, mainly to attract new customers.  ",1,0.727272727,-1,"nel Regno Unito, un sondaggio indico' che il 17% di piccoli esercizi commerciali britannici usavano Twitter, principalmente per attrarre nuovi clienti.",1,1,7,7,0,-1,1,7,0,7,"Nel Regno Unito, un sondaggio ha indicato che il 17% delle piccole imprese britanniche utilizzava Twitter, soprattutto per attirare nuovi clienti.  ",1,1,7,7,0,-1,1,7,0,7
We should abandon Valentine's day,Dovremmo abbandonare San Valentino,Robert Everett-Green of The Globe and Mail wrote that Valentine's Day was reminiscent of the works of Marquis de Sade and the 1973 French/Italian film La Grande Bouffe.  ,0,0,0,Robert Everett-Green del The Globe and Mail ha scritto che San Valentino ricorda le opere del Marchese de Sade e il film franco-italiano La Grande Bouffe del 1973.,0,0.915862179,10,2,8,,,2,2,0,Robert Everett - Verde di The Globe e Mail ha scritto che San Valentino ricordava le opere di Marquis de Sade e il film francese 1973 / italiano La Grande Bouffe.  ,0,1,8,0,8,,,0,0,0
We should abandon Valentine's day,Dovremmo abbandonare San Valentino,"Shafik Rehman - Journalist, political analyst, and writer, who is best known for introducing Valentine's Day in Bangladesh.",0,0,0,"Shafik Rehman - giornalista, analista politico, e scrittore, e' meglio cosciuto per aver introdotto il giorno di S.Valentino in Bangladesh",1,0.537933932,10,6,4,-1,1,6,0,6,"Shafik Rehman - Giornalista, analista politico e scrittore, che è meglio conosciuto per aver introdotto San Valentino in Bangladesh.",0,0.906898127,10,1,9,,,1,0,1
We should abandon Zionism,Dovremmo abbandonare il sionismo,"Hamas spokesman Ismail Abu Shanab stated that he expected to see ""a series of operations against the Zionist enemy, as a result of the daily brutal crimes against our people."" .  ",1,1,1,"Il portavoce di Hamas, Ismail Abu Shanab, ha dichiarato che si aspettava di vedere ""una serie di operazioni contro il nemico sionista, come risultato dei brutali crimini quotidiani contro il nostro popolo"". .  ",1,0.706021051,10,7,3,1,1,7,7,0,"Il portavoce di Hamas, Ismail Abu Shanab, ha dichiarato di aspettarsi di vedere ""una serie di operazioni contro il nemico sionista, a seguito dei crimini brutali quotidiani contro il nostro popolo"".  ",1,0.661280299,10,7,3,1,0.522877004,7,6,1
We should abandon Zionism,Dovremmo abbandonare il sionismo,"In 1917, Britain drafted the Balfour Declaration, becoming the first Great Power to support Zionist calls for a 'Jewish National Home' in Palestine.",1,0.833333333,-1,"nel 1917, abbozzo' la dichiarazione Balfour, diventando la prima grande potenza a sostenere il propsito sionista per una ""casa nazionale ebraica"" in Palestina.",0,0.731246104,10,3,7,1,1,3,2,1,"Nel 1917 la Gran Bretagna ha redatto la Dichiarazione Balfour, diventando il primo Grande Power a sostenere le chiamate sioniste per una ""Casa Nazionale ebraica"" in Palestina.",0,0.571272099,10,5,5,-1,1,5,0,5
We should abandon alimony,Dovremmo abbandonare l'alimonia,*[[Alimony|Spousal support]] states that alimony is affected by .  ,0,0,0,*[[alimenti/supporto matrimoniale]] dichiara che gli alimenti son influenzati da.,0,1,7,0,7,,,0,0,0,* [ [ Alimony | Supporto Spousal]] afferma che l'alimonia è interessata da.  ,0,1,8,0,8,,,0,0,0
We should abandon alimony,Dovremmo abbandonare l'alimonia,"In 2012, Massachusetts signed into law comprehensive alimony reform.",0,0.4,-1,"Nel 2012, il Massachusetts ha firmato una riforma globale sugli assegni di mantenimento.",0,0.792847286,10,2,8,1,1,2,1,1,"Nel 2012, il Massachusetts ha firmato in legge una riforma globale di alimonia.",0,0.767344228,10,3,7,,,3,2,1
We should abandon brick and mortar companies,Dovremmo abbandonare le aziende di mattoni e mortai,"E-learning is increasingly being utilized by students who may not want to go to traditional brick and mortar schools due to severe allergies or other medical issues, fear of school violence and school bullying and students whose parents would like to homeschool but do not feel qualified .",0,0.15,1,"L'e-learning è sempre più utilizzato da studenti che potrebbero non voler frequentare fisicamente le scuole tradizionali a causa di gravi allergie o altri problemi di salute, del timore della violenza e del bullismo scolastici e da studenti i cui genitori vorrebbero l'insegnamento da casa ma non si sentono qualificati per farlo.",0,0.904369698,10,1,9,,,1,1,0,"L'e-learning è sempre più fruito dagli studenti che potrebbero non voler andare nelle scuole di mattoni e mortai tradizionali a causa di gravi allergie o di altre questioni mediche, paura della violenza scolastica e del bullismo scolastico e degli studenti i cui genitori vorrebbero l'homeschool ma non si sentono qualificati.",0,0.67759138,10,3,7,1,1,3,3,0
We should abandon brick and mortar companies,Dovremmo abbandonare le aziende di mattoni e mortai,"Originally hand-made and distributed from a residential location, the company has since expanded to several brick-and-mortar stores and maintains a heavy online presence.",0,0.5,-1,"inizialmente fatta a mano e distribuita da una sede residenziale, la compagnia si e' estesa a parecchi negozi di mattoni e malta e mantiene una forte presenza online.",0,1,7,0,7,,,0,0,0,"Originariamente fatta a mano e distribuita da una località residenziale, l'azienda si è da allora ampliata a diversi negozi di mattoni e mantiene una pesante presenza online.",0,0.822782,10,2,8,,,2,0,2
We should abandon chain stores,Dovremmo abbandonare i negozi di catena,"China Nepstar Chain Drugstore Limited (NPD.NYSE) plans to open 1,050 new chain stores in 2008 and expects to have more than 3000 outlets with about eight million of registered customers by then, said Qian Jiannong, CEO of China Nepstar Chain Drugstore.  ",1,0.7,-1,"China Nepstar Chain Drugstore Limited (NPD.NYSE) progetta di aprire 1050 nuovi negozi a catena nel 2008 e prevede di avere piu' di 300 punti vendita con circa otto milioni di clienti registrati da allora, secondo Qian Jiannong, amministratore delegato di China Nepstar Chain Drugstore.",0,0.645286783,10,4,6,-1,1,4,0,4,"China Nepstar Chain Drugstore Limited (NPD.NYSE) prevede di aprire 1.050 nuovi negozi di catena nel 2008 e prevede di avere più di 3000 sbocchi con circa otto milioni di clienti registrati entro allora, ha detto Qian Jiannong, CEO di China Nepstar Chain Drugstore.  ",0,0.635122405,10,4,6,,,4,0,4
We should abandon chain stores,Dovremmo abbandonare i negozi di catena,"In July 2015, Smart-Holding and Fozzy Group reached an agreement to implement a joint project to fully restore the operations of Amstor retail chain.",0,0.2,0,"Nel luglio 2015, Smart-Holding e Fozzy Group hanno raggiunto un accordo per la realizzazione di un progetto congiunto per il completo ripristino delle attività della catena di vendita al dettaglio Amstor.",0,0.844205551,10,2,8,,,2,0,2,A luglio 2015 Smart - Holding e Fozzy Group hanno raggiunto un accordo per implementare un progetto congiunto per ripristinare completamente le operazioni di Amstor retail.,0,1,9,0,9,,,0,0,0
We should abandon motorcycles,Dovremmo abbandonare le moto,".. that when invited to lunch at the Bank of England, the economist Adam Ridley arrived by motorcycle?",0,0,0,"... che quando è stato invitato a pranzo alla Banca d'Inghilterra, l'economista Adam Ridley è arrivato in moto?",0,1,7,0,7,,,0,0,0,".. che quando invitato a pranzo alla Bank of England, l'economista Adam Ridley è arrivato in moto?",0,1,7,0,7,,,0,0,0
We should abandon motorcycles,Dovremmo abbandonare le moto,"Preliminary results from a study in the United Kingdom, conducted by the University of Nottingham for the Department for Transport, show that filtering is responsible for around 5% of motorcycle Killed or Seriously Injured (KSI) accidents.",0,0,0,"risultati preliminari da uno studio nel Regno Unito condotto dalla Universita di Nottingham per i Dipartimento dei Trasporti, mostra che il filtraggio e' responsabile di circa il 5% di incidenti mortali o con gravi lesioni (KSI).",0,1,7,0,7,,,0,0,0,"I risultati preliminari di uno studio condotto nel Regno Unito, condotto dall'Università di Nottingham per il Dipartimento per i Trasporti, mostrano che il filtraggio è responsabile di circa 5% incidenti di moto Ucciso o gravemente Ferito (KSI).",0,1,7,0,7,,,0,0,0
We should abandon speed limit enforcement,Dovremmo abbandonare l'applicazione del limite di velocità,"In 2005, 2006, 2008 and 2009 the California legislature considered, but did not pass, bills to implement speed limit enforcement cameras .",0,0.2,0,"Nel 2005, 2006, 2008 e 2009 il legislatore californiano ha preso in considerazione, senza approvarle, le proposte di legge per l'implementazione di telecamere per il rispetto dei limiti di velocità.",0,0.677803686,10,3,7,1,1,3,1,2,"Nel 2005, 2006, 2008 e 2009 la legislatura californiana considerava, ma non passava, bollette per implementare le telecamere delle forze dell'ordine.",0,1,7,0,7,,,0,0,0
We should abandon speed limit enforcement,Dovremmo abbandonare l'applicazione del limite di velocità,The Automobile Association was established in 1905 in the United Kingdom to help motorists avoid police speed traps.,0,0.3,0,l'Associazione Automobilistica fu creata nel 1905 nel Regno Unito per aiutare i condocenti di veicoli ad evitare gli autovelox,0,0.934586211,10,1,9,,,1,1,0,L'Associazione Automobilistica è stata istituita nel 1905 nel Regno Unito per aiutare gli automobilisti a evitare le trappole della velocità della polizia.,0,1,7,0,7,,,0,0,0
We should abandon tabloid journalism,Dovremmo abbandonare il giornalismo tabloid,"Montreal has numerous weekly tabloids and community newspapers serving various neighbourhoods, ethnic groups and schools.",0,0,0,"Montreal ha numerosi tabloid settimanali e giornali per le comunità locali che servono vari quartieri, gruppi etnici e scuole.",1,0.651382806,10,6,4,-1,1,6,0,6,"Montreal dispone di numerosi tabloid settimanali e quotidiani di comunità che servono vari quartieri, gruppi etnici e scuole.",0,0.610175313,11,4,7,-1,1,4,0,4
We should abandon tabloid journalism,Dovremmo abbandonare il giornalismo tabloid,"Unlike other Philippine tabloids, Inquirer Libre seeks to provide commuters access to decent, useful and meaningful news and current events.",0,0,0,"a differenza di atri tabloid filippini, l' Inquirer Libre cerca di fornire ai lavoratori pendolari informazioni di utili e significativi eventi attuali.",1,0.725439281,10,7,3,-1,1,7,0,7,"A differenza di altri tabloid filippini, Inquirer Libre cerca di fornire ai pendolari l'accesso a notizie e eventi di attualità dignitosi, utili e significativi.",1,0.800364206,10,8,2,-1,1,8,0,8
We should abandon the presidential system,Dovremmo abbandonare il sistema presidenziale,"(This led some Congress party leaders to demand a move towards a presidential system, with a more powerful directly elected executive.)",1,0.636363636,-1,"(Questo ha portato alcuni leader di partito del Congresso a chiedere un passo verso un sistema presidenziale, con un esecutivo più potente eletto direttamente).",1,0.653965394,10,6,4,-1,1,6,1,5,"(Questo ha portato alcuni leader di partito del Congresso a chiedere una mossa verso un sistema presidenziale, con un esecutivo più potente direttamente eletto.)",1,0.714600434,10,7,3,1,0.63302198,7,4,3
We should abandon the presidential system,Dovremmo abbandonare il sistema presidenziale,"The Junta had already held a staged referendum to abolish the monarchy on 29 July 1973, and passed a new Constitution which established a presidential republic (with junta leader Georgios Papadopoulos as President).",1,0.8,-1,"la giunta aveva gia' organizzato un referendum per abolire la monarchia il 29 luglio 1973, e varo' una nuova Costituzione che istituiva unaa repubblica presidenziale (con il capo della giunta Georgios Papadopoulos come presidente)",1,0.720023324,10,7,3,-1,0.70184387,7,3,4,"La Giunta aveva già tenuto un referendum inscenato per abolire la monarchia il 29 luglio 1973, e ha approvato una nuova Costituzione che ha istituito una repubblica presidenziale (con il leader della giunta Georgios Papadopoulos come Presidente).",1,0.707739866,10,7,3,-1,0.551735345,7,2,5
We should abandon the sexual revolution,Dovremmo abbandonare la rivoluzione sessuale,"Naomi Wolf considered that the sexual revolution had paradoxically intensified the importance of the virgin-whore split, leaving women to contend with the worst aspects of both images .",1,0.9,1,"Naomi Wolf riteneva che la rivoluzione sessuale avesse paradossalmente intensificato l'importanza della scissione tra vergine e puttana, lasciando le donne a confrontarsi con gli aspetti peggiori di entrambe le immagini.",1,0.90327368,10,9,1,1,0.522877004,9,7,2,"Naomi Wolf ha ritenuto che la rivoluzione sessuale avesse paradossalmente intensificato l'importanza della scissione vergine - puttana, lasciando le donne a contenderne gli aspetti peggiori di entrambe le immagini.",1,0.756562675,13,10,3,1,0.66513415,10,9,1
We should abandon the sexual revolution,Dovremmo abbandonare la rivoluzione sessuale,Any form of sexual revolution was derided as promiscuity and leading to a rise in sexually transmitted infections.,1,0.8,1,ogni forma di rivoluzione sessuale e' stata derisa come promisquita' e ha portato ad un aumento di infezioni a trasmissione sessuale,1,1,7,7,0,1,1,7,7,0,Qualsiasi forma di rivoluzione sessuale è stata derisa come promiscuità e portando a un aumento delle infezioni sessualmente trasmissibili.,1,0.944272164,10,9,1,1,1,9,8,1
We should abandon voter registration,Dovremmo abbandonare la registrazione degli elettori,"In 1998, the state Supreme Court ruled that signatures from half the registered voters of the affected area are required to propose a new county, shelving many county secession movements in the state.",0,0,0,"Nel 1998, la Corte Suprema dello Stato ha stabilito che per proporre una nuova contea servono le firme della metà degli elettori registrati dell'area interessata, accantonando i molti movimenti favorevoli alla secessione della contea dallo Stato.",0,0.846381534,10,2,8,,,2,2,0,"Nel 1998 la Corte Suprema dello Stato ha stabilito che le firme della metà degli elettori registrati della zona colpita sono tenute a proporre una nuova contea, scaffalando molti movimenti di secessione della contea nello Stato.",0,1,7,0,7,,,0,0,0
We should abandon voter registration,Dovremmo abbandonare la registrazione degli elettori,"In the late 19th century, the white-dominated state legislature passed several laws that made voter registration and voting more difficult, including payment of a poll tax, and resulted in reducing voting by many blacks and poor whites.",0,0.3,0,"nel tardo 19esimo secolo, la legislatura statale dominata dai bianchi approvo' parecchie leggi che resero la registrazione dei votanti e le votazioni piu' difficoltose, includendo una tassa sul voto, risultando in una riduzione delle votazione da parte di gente di colore e poveri [RES].",1,0.725439281,10,7,3,1,1,7,7,0,"Alla fine del 19 secolo, la legislatura dello stato dominato dal white-dominato ha approvato diverse leggi che hanno reso più difficile la registrazione degli elettori e le votazioni, incluso il pagamento di una tassa di sondaggio, e hanno comportato la riduzione del voto da parte di molti neri e poveri bianchi.",1,0.580300764,10,6,4,-1,1,6,5,1
We should abandon weddings,Dovremmo abbandonare i matrimoni,"It dominates the western skyline of the city of Turku was designed by Professor Lars Sonck and is one of the most popular wedding churches in Turku being able to seat 1,800 people.",0,0,0,"Dominante lo skyline occidentale di Turku, progettata dal professor Lars Sonck, è una delle chiese nuziali più popolari della città, in grado di ospitare 1.800 persone.",0,1,8,0,8,,,0,0,0,Domina lo skyline occidentale della città di Turku è stato progettato dal professor Lars Sonck ed è una delle chiese di matrimonio più popolari di Turku in grado di ospitare 1.800 persone.,0,1,7,0,7,,,0,0,0
We should abandon weddings,Dovremmo abbandonare i matrimoni,"The show's executive producer, Diederick Santer, described the wedding as ""the perfect opportunity"" to bring the characters back to the show.",0,0.3,-1,"il produttore esecutivo dello spettacolo, Diederick Santer, descrisse il matrimonio come una opportunita' perfetta di riportare i personaggi nello spettacolo.",0,0.643570984,10,4,6,-1,1,4,0,4,"Il produttore esecutivo dello show, Diederick Santer, ha descritto il matrimonio come ""l'occasione perfetta"" per riportare i personaggi in mostra.",0,0.892753473,10,1,9,-1,1,1,0,1
We should abolish competition laws,Dovremmo abolire le leggi sulla concorrenza,"One view, mostly closely associated with the ""Chicago School of economics"" suggests that antitrust laws should focus solely on the benefits to consumers and overall efficiency, while a broad range of legal and economic theory sees the role of antitrust laws as also controlling economic power in the public interest .",1,0.6,-1,"Un punto di vista, per lo più strettamente associato alla ""Chicago School of economics"", suggerisce che le leggi antitrust dovrebbero concentrarsi esclusivamente sui benefici per i consumatori e sull'efficienza complessiva, mentre un'ampia gamma di teorie giuridiche ed economiche vede il ruolo delle leggi antitrust come controllo del potere economico anche nell'interesse pubblico.",0,0.735780113,10,2,8,-1,1,2,0,2,"Una visione, per lo più strettamente associata alla ""Chicago School of Economics"" suggerisce che le leggi antitrust dovrebbero concentrarsi unicamente sui benefici per i consumatori e l'efficienza complessiva, mentre un'ampia gamma di teoria giuridica ed economica vede il ruolo delle leggi antitrust come anche il controllo del potere economico nell'interesse pubblico.",0,0.64746059,10,4,6,,,4,2,2
We should abolish competition laws,Dovremmo abolire le leggi sulla concorrenza,Telecommunications policy outlines antitrust laws as is common for industries with large barriers to entry.,0,0.4,-1,la politica delle telecomunicazioni delinea leggi antitrust come e' comune per le industrie con grossi ostacoli all'inizio.,0,0.754571982,10,3,7,,,3,0,3,La politica delle telecomunicazioni delinea le leggi antitrust come è comune per le industrie con grandi barriere all'ingresso.,0,0.829621139,10,2,8,,,2,0,2
We should abolish credit scores,Dovremmo abolire i punteggi di credito,"Government bonds and T-bills are considered as good quality loans whereas junk bonds, corporate credits to low credit score firms etc. are bad quality loans.",0,0.142857143,0,"I titoli di stato e le cambiali a T sono considerati prestiti di buona qualita' mentre i prestiti spazzatura, i crediti societari a societa' a basso punteggio di credito sono prestiti di cattiva qualita'.",1,0.518805381,10,5,5,1,1,5,3,2,"I titoli di Stato e le T-bollette sono considerati prestiti di buona qualità mentre i titoli spazzatura, i crediti societari a società a basso rischio di credito etc. sono prestiti di pessima qualità.",0,0.58667586,10,4,6,1,1,4,4,0
We should abolish credit scores,Dovremmo abolire i punteggi di credito,"Liz Weston writes that some consumer advocates refer to these other [educational] credit scores as ""FAKO scores"" (a play on acronym of FICO) .",0,0.2,0,"Liz Weston scrive che alcuni sostenitori dei consumatori si riferiscono a questi altri punteggi di credito [formativo] come ""punteggi FAKO"" (una parodia dell'acronimo di FICO) .",0,0.675070975,10,3,7,,,3,3,0,"Liz Weston scrive che alcuni sostenitori del consumatore fanno riferimento a questi altri punteggi di credito [ educativi] come ""punteggi FAKO"" (un gioco su acronimo di FICO).",0,0.730582289,12,3,9,1,1,3,3,0
We should abolish dual citizenship,Dovremmo abolire la doppia cittadinanza,"The Lithuanian Seimas (parliament) passed a temporary law, expiring in 2010, that granted dual citizenship in exceptional cases, most notably to those who were Lithuanian citizens prior to 1940 and who fled during the Soviet occupations, as well as to their children and grandchildren.",0,0.416666667,-1,"Il parlamento (Seimas) lituano ha approvato una legge temporanea, con scadenza nel 2010, che ha concesso la doppia cittadinanza in casi eccezionali. In particolare, a coloro che erano cittadini lituani prima del 1940 e che fuggirono durante le occupazioni sovietiche, nonché ai loro figli e nipoti.",0,0.646255872,10,5,5,,,5,0,5,"Il lituano Seimas (parlamento) ha approvato una legge temporanea, in scadenza nel 2010, che ha concesso la doppia cittadinanza in casi eccezionali, in particolare a coloro che erano cittadini lituani prima del 1940 e che sono fuggiti durante le occupazioni sovietiche, nonché ai loro figli e nipoti.",0,0.536273303,10,5,5,-1,1,5,0,5
We should abolish dual citizenship,Dovremmo abolire la doppia cittadinanza,Former President Sadat added that any Egyptian who has dual nationality is exempted from military service and this is still in effect.,0,0.1,0,l'ex presidente Sadatha aggiunto che ogni egiziano in posseso di doppia cittadinanza sara' esentato dal sevizio militare e questo e' ancora in vigore,1,0.712886215,10,7,3,-1,0.528995613,7,3,4,L'ex presidente Sadat ha aggiunto che qualsiasi egiziano che abbia la doppia nazionalità è esentato dal servizio militare e questo è ancora in vigore.,0,0.549436802,10,5,5,1,1,5,3,2
We should abolish emissions trading,Dovremmo abolire il trading delle emissioni,"On June 29, 2009, in Nashville, Tennessee, four thousand people rallied against proposed emissions trading (cap and trade) energy in Congress and universal health care .",1,0.888888889,0,"Il 29 giugno 2009, a Nashville, Tennessee, quattromila persone si sono mobilitate contro la proposta del Congresso relativa allo scambio di quote di emissione di energia al Congresso e all'assistenza sanitaria universale.",1,0.719039909,10,7,3,1,1,7,7,0,"Il 29 giugno 2009, a Nashville, in Tennessee, quattromila persone si sono radunate contro proposte di scambio di quote di emissioni (cap and trade) in Congresso e assistenza sanitaria universale.",1,0.592175674,10,6,4,1,1,6,6,0
We should abolish emissions trading,Dovremmo abolire il trading delle emissioni,"The American Enterprise Institute, Environmental economist Jack Pezzey, economist Jeffrey Sachs (director of the Earth Institute of Columbia University), Yale economist William Nordhaus, The Earth Policy Institute, The Australia Institute, the Centre for Independent Studies, and Harvard professor, Gregory Mankiw also prefer carbon taxes to cap-and-trade.",1,0.8,1,"l'American Enterprise Institute, l'ecomomista ambientale Jack Pezzey, l'economista Jeffrey Sachs (direttore del' Heart Institute della Columbia University), l'economista di Yale William Mordhaus, il Heart Policy Institute, l' Australia Institute, il Centro per Studi Indipendenti, e il professore di Harvard, Gregory Mankiw preferiscono le tasse sul carbonio al protezione-e-commercio.",1,0.63960695,10,6,4,-1,0.528995613,6,4,2,"L'American Enterprise Institute, l'economista ambientale Jack Pezzey, l'economista Jeffrey Sachs (direttore dell'Earth Institute of Columbia University), l'economista di Yale William Nordhaus, The Earth Policy Institute, The Australia Institute, il Centre for Independent Studies, e il professore di Harvard, Gregory Mankiw preferiscono anche le tasse al carbonio al cap-and-trade.",1,0.593433452,10,6,4,1,1,6,5,1
We should abolish the presidential pardon,Dovremmo abolire il pardon presidenziale,"According to Bob Woodward, Nixon Chief of Staff Alexander Haig proposed a pardon deal to Ford.",0,0,0,"Secondo Bob Woodward, il capo dello staff di Nixon, Alexander Haig, ha proposto un accordo di grazia a Ford.",0,0.753522133,10,3,7,-1,1,3,1,2,"Secondo Bob Woodward, il capo dello Staff di Nixon Alexander Haig propose un pardon accordo a Ford.",0,0.65610113,10,4,6,-1,1,4,2,2
We should abolish the presidential pardon,Dovremmo abolire il pardon presidenziale,"In March 1991, parliament passed an amnesty law that pardoned most political crimes prior to its enactment, excepting crimes perpetrated against foreign diplomats or certain crimes referred by the cabinet to the Higher Judicial Council.  ",0,0.5,-1,"nel marzo 1991, il parlamento approvo' una legge di amnistia che perdonava la maggior parte dei crimini politici prima della sua emanazione, fuorche' crimini contro diplomatici stranieri o certi crimini riferiti dal gabinetto del Consiglio Giudiziario Superiore.",1,0.636943076,10,6,4,1,1,6,4,2,"Nel marzo 1991, il parlamento ha approvato una legge di amnistia che ha paralizzato la maggior parte dei crimini politici prima della sua emanazione, eccezando i crimini perpetrati contro diplomatici stranieri o alcuni reati rinviati dal gabinetto al Consiglio giudiziario superiore.  ",0,0.582521164,10,4,6,1,1,4,2,2
We should adopt catholicism,Dovremmo adottare il cattolicesimo,"While studying in a Roman Catholic seminary, he allegedly molested four boys, who have since filed suit against him, the Archdiocese of Galveston-Houston, Archbishop Joseph Fiorenza and Pope Benedict XVI, charging that the church conspired to cover up the crime.",0,0.090909091,0,"Mentre studiava in un seminario cattolico, avrebbe molestato quattro ragazzi che da allora hanno intentato una causa contro di lui, l'arcidiocesi di Galveston-Houston, l'arcivescovo Joseph Fiorenza e papa Benedetto XVI, accusando la Chiesa di aver cospirato per coprire il crimine.",0,0.864943757,10,2,8,,,2,0,2,"Mentre studiava in un seminario cattolico romano, presumibilmente ha molestato quattro ragazzi, che da allora hanno intentato causa contro di lui, l'Arcidiocesi di Galveston - Houston, l'arcivescovo Joseph Fiorenza e papa Benedetto XVI, addebitando che la chiesa ha cospirato per coprire il delitto.",0,0.828858816,10,2,8,-1,1,2,0,2
We should adopt catholicism,Dovremmo adottare il cattolicesimo,"In his report to the Congregation, he stated that the crossover of Montenegro to Catholicism is especially important in the spread of Catholicism in Serbia and the Balkans in general.  ",0,0.2,0,"nel suo rapporto alla Congregazione, ha dichiarato che il passaggio del Montenegro al cattolicesimo e' specialmente importante per il diffondersi del cattoicesimo in Serbia e in generale nei Balcani",1,0.714082004,10,7,3,1,1,7,7,0,Nella sua relazione alla Congregazione ha dichiarato che il crossover del Montenegro al cattolicesimo è importante soprattutto nella diffusione del cattolicesimo in Serbia e nei Balcani in generale.  ,1,0.517089818,10,5,5,1,1,5,5,0
We should adopt environmental justice,Dovremmo adottare la giustizia ambientale,"Mossville Environmental Action Now has worked since the 1980s as environmental justice advocates to address the industrial toxins that pollute their community, Mossville, Louisiana .",1,0.733333333,1,"Il Mossville Environmental Action Now lavora dagli anni '80 come sostenitore della giustizia ambientale per affrontare il problema delle tossine industriali che inquinano la comunità di Mossville, in Louisiana.",1,0.783536416,10,8,2,1,1,8,8,0,"Mossville Environmental Action Now ha lavorato fin dagli anni ' 1980s come sostenitori della giustizia ambientale per affrontare le tossine industriali che inquinano la loro comunità, Mossville, Louisiana.",1,0.546201689,10,6,4,,,6,6,0
We should adopt environmental justice,Dovremmo adottare la giustizia ambientale,"Most of Shrader-Frechette's research work analyzes the ethical problems in risk assessment, public health, or environmental justice - especially those related to radiological, ecological, and energy-related risks.",0,0.2,0,"gran parte del lavoro di ricerca Shrader-Frechette analizza i problemi etici di valutazione del rischio, salute pubblica, o giustizia ambientalistica, in special modo quelli legati ai rischi radiologici, ecologici, e relativi all'energia.",0,0.91232488,10,1,9,,,1,1,0,"La maggior parte dei lavori di ricerca di Shrader-Frechette analizza i problemi etici nella valutazione dei rischi, nella salute pubblica o nella giustizia ambientale - soprattutto quelli legati ai rischi radiologici, ecologici e legati all'energia.",0,1,7,0,7,,,0,0,0
We should adopt polyamory,Dovremmo adottare il poliamorio,"Emile Armand was an influential French individualist anarchist, free love/polyamory and pacifist/antimilitarist propagandist and activist.",0,0.076923077,0,"Emile Armand era un influente anarchico individualista francese, fautore del libero amore/poligamo e pacifista/antimilitarista, propagandista e attivista.",0,0.557754189,10,5,5,1,1,5,5,0,"Emile Armand era un influente individualista francese, libero amore / poliamorio e pacifista / antimilitarista propagandista e attivista.",0,0.744076199,10,3,7,,,3,3,0
We should adopt polyamory,Dovremmo adottare il poliamorio,"One prominent rabbi who does accept polyamory is Sharon Kleinbaum who was ordained in Reconstructionist Judaism which considers biblical Jewish law as not considered binding, but is treated as a valuable cultural remnant that should be upheld unless there is reason for the contrary.",1,0.7,1,"Un rabbino di spicco che accetta il poliamore è Sharon Kleinbaum, ordinata nell'ebraismo ricostruttivista che ritiene la legge biblica ebraica non vincolante ma prezioso residuo culturale da sostenere a meno che non vi sia ragione del contrario.",1,0.542651001,10,6,4,1,1,6,6,0,"Un rabbino di primo piano che accetta il poliamorio è Sharon Kleinbaum che è stato ordinato nell'ebraismo ricostruzionista che considera la legge ebraica biblica come non considerato vincolante, ma è trattato come un prezioso residuo culturale che dovrebbe essere accolto a meno che non ci sia ragione del contrario.",1,0.897707378,10,9,1,1,1,9,9,0
We should ban Gerrymandering,Dovremmo vietare Gerrymandering,"A quantitative measure of the effect of gerrymandering is the efficiency gap, computed from the difference in the wasted votes for two different political parties summed over all the districts.",0,0.3,0,"Una misura quantitativa dell'effetto della manipolazione dei collegi elettorali è il divario di efficienza, calcolato sulla differenza dei voti sprecati per due diversi partiti politici sommati in tutti i distretti.",0,0.828457896,10,3,7,,,3,2,1,"Una misura quantitativa dell'effetto di gerrymandering è il gap di efficienza, calcolato dalla differenza nei voti sprecati per due diversi partiti politici sommati su tutti i distretti.",0,0.517821226,10,5,5,1,0.528995613,5,3,2
We should ban Gerrymandering,Dovremmo vietare Gerrymandering,There were also talks of reforming electoral law to reduce gerrymandering in constituency boundaries and guarantee greater proportionality.,1,0.9,1,si e' parlato di riformare la legge elettorale per ridurre la manipolazione nei collegi elettorali e garantire una maggiore proporzionalita'.,1,0.624868241,10,6,4,1,1,6,6,0,Ci sono stati anche colloqui di riforma della legge elettorale per ridurre le gerrymandering nei confini circoscrizionali e garantire una maggiore proporzionalità.,1,0.743363593,10,7,3,1,1,7,7,0
We should ban alcohol advertising,Dovremmo vietare la pubblicità degli alcolici,"Anheuser-Busch, being a conglomerate with non-alcoholic properties, complies with the French alcohol advertising ban in Formula One by placing their Busch Entertainment theme park logos (mostly SeaWorld) where their Budweiser logo would appear on the Williams F1 car at races where alcohol advertising is banned and in Middle Eastern countries, where alcohol advertising is discouraged.",1,0.6,1,"Anheuser-Busch, essendo una conglomerata con attività nel settore delle bevande analcoliche, rispetta il divieto francese di pubblicità di alcolici in Formula Uno mettendo i propri loghi dei parchi a tema Busch Entertainment (per lo più SeaWorld), laddove dovrebbe apparire il logo Budweiser sull'auto Williams F1, nelle gare in cui la pubblicità di alcolici è vietata e nei paesi mediorientali, in cui la pubblicità di alcolici è sconsigliata.",0,0.825152197,10,2,8,,,2,2,0,"Anheuser-Busch, essendo un conglomerato con proprietà non alcoliche, è conforme al divieto di pubblicità alcolica francese in Formula Uno inserendo i loro loghi di parco a tema Busch Entertainment (perlopiù SeaWorld) dove il loro logo Budweiser apparirebbe sulla vettura della Williams F1 alle gare dove è vietata la pubblicità alcolica e nei paesi mediorientali, dove la pubblicità degli alcolici è scoraggiata.",0,0.749268891,10,3,7,1,1,3,3,0
We should ban alcohol advertising,Dovremmo vietare la pubblicità degli alcolici,"Preventing or reducing the harm has been called for via increased taxation of alcohol, stricter regulation of alcohol advertising and the provision of brief Interventions.",1,0.7,1,"prevenire e ridurre il danno e' stato richiesto attraverso una maggiore tassazione sull' alcool,una piu' ferrea regolamentazione di pubblicita' sugli alcolici e la fornitura di interventi brevi.",1,0.530321751,10,5,5,1,1,5,5,0,"Prevenire o ridurre il danno è stato chiesto attraverso una maggiore tassazione dell'alcol, una regolamentazione più severa della pubblicità degli alcolici e la predisposizione di brevi Interventi.",1,0.537145444,10,5,5,1,1,5,5,0
We should ban attack ads,Dovremmo vietare gli annunci di attacco,"Vanity, though probably more of an attack ad.",0,0.111111111,0,"Vanità, anche se probabilmente è più un annuncio pubblicitario di attacco.",0,1,7,0,7,,,0,0,0,"Vanity, anche se probabilmente più di un attacco ad.",0,1,7,0,7,,,0,0,0
We should ban attack ads,Dovremmo vietare gli annunci di attacco,"An organization called Save My Care spent $500,000 to release a series of attack ads against 24 House members who voted for the AHCA, including one about Young that decries his vote claiming it will raise healthcare costs for Alaskans.",0,0.090909091,0,"una organizzazione chiamata Save My Care spese $500.000 per pubblicare una serie di attacchi  pubblicitari contro 24 membri della Camera che votarono per AHCA, compreso uno su Young che afferma il suo voto aumentera' i costi della sanita' per gli Alaskans.",0,0.742675166,10,3,7,1,1,3,1,2,"Un'organizzazione chiamata Save My Care ha speso $500.000 dollari per rilasciare una serie di annunci di attacco contro 24 membri della Camera che hanno votato per l'AHCA, tra cui uno su Young che decriva il suo voto sostenendo che alzerà i costi sanitari per gli Alaskani.",1,0.664700028,10,7,3,1,1,7,5,2
We should ban billboards,Dovremmo vietare i cartelloni,Billboard is a reliable source and it's data collected by Nielsen BDS and Nielsen Soundscan.,0,0.3,-1,Billboard è una fonte affidabile e ha i dati raccolti da Nielsen BDS e Nielsen Soundscan.,1,0.548566058,10,5,5,-1,1,5,0,5,Cartellone è una fonte affidabile ed è dato dai dati raccolti da Nielsen BDS e Nielsen Soundscan.,1,0.625545528,12,7,5,-1,1,7,0,7
We should ban billboards,Dovremmo vietare i cartelloni,"Throughout 2011 and 2012, trap music maintained a strong presence on the mainstream Billboard music charts with a number of records released by rappers such as Young Jeezy, Chief Keef and Future.",0,0,0,"per tutto il 2011 e 2012, la musica rap ha mantenuto una forte presenza nelle classifiche musicali tradizionali con una serie di dischi realizzati da artisti come Young Jeezy, Chief Keef e Future",0,1,7,0,7,,,0,0,0,"Durante tutto il 2011 e il 2012, la musica trap ha mantenuto una forte presenza sulle classifiche della musica mainstream Billboard con diversi record rilasciati da rapper come Young Jeezy, Chief Keef e Future.",0,1,7,0,7,,,0,0,0
We should ban burqas,Dovremmo vietare i burqa,"European Commissioner Franco Frattini said in November 2006, that he did not favour a ban on the burqa .",1,1,-1,Il commissario europeo Franco Frattini ha dichiarato nel novembre 2006 di non essere favorevole al divieto del burqa.,1,0.765382984,10,8,2,-1,1,8,0,8,"Lo ha detto il commissario europeo Franco Frattini nel novembre 2006, che non ha favorito il divieto di burqa.",1,0.756229099,10,7,3,-1,0.66513415,7,2,5
We should ban burqas,Dovremmo vietare i burqa,On Tuesday 13 July 2010 the Assembly overwhelmingly approved a bill banning burqas and niqabs.  ,1,1,1,martedi 13 luglio l'assemblea ha approvato in modo schiacciante un documento di divieto di burqas e niqabs,1,1,7,7,0,1,1,7,7,0,Il martedì 13 luglio 2010 l'Assemblea ha approvato in maniera travolte un disegno di legge che vieta burqa e niqabs.  ,1,1,7,7,0,1,1,7,7,0
We should ban chewing tobacco,Dovremmo vietare il tabacco da masticare,"In a comprehensive review of all reports from previous years, one study noted ""The use of moist snuff and chewing tobacco imposes minimal risks for cancers of the oral cavity and other upper respiratory sites, with relative risks ranging from 0.6 to 1.7.""",1,0.8,1,"In una revisione completa di tutti i rapporti degli anni precedenti, uno studio ha osservato che ""L'uso di tabacco da fiuto e da masticare impone rischi minimi per i tumori del cavo orale e di altre sedi delle vie respiratorie superiori, con rischi relativi che vanno da 0,6 a 1,7"".",1,0.791852055,10,8,2,-1,1,8,1,7,"In una revisione completa di tutte le segnalazioni degli anni precedenti, uno studio ha notato ""L'uso del tabacco umido e del tabacco da masticare impone rischi minimi per i tumori della cavità orale e di altri siti respiratori superiori, con relativi rischi che vanno dal 0,6 al 1,7"".",1,0.822262159,11,9,2,-1,1,9,0,9
We should ban chewing tobacco,Dovremmo vietare il tabacco da masticare,"In 1938 R.J. Reynolds marketed eighty-four brands of chewing tobacco, twelve brands of smoking tobacco, and the top-selling Camel brand of cigarettes.",0,0.1,0,"nel 1938 R.J. Reynolds introdusse sul mercato 84 marche di tabacco da masticare, 12 marche di tabacco da fumare, e la marca campione di vendite Camel.",0,0.91232488,10,1,9,,,1,0,1,"Nel 1938 R.J. Reynolds commercializza ottantacinque marchi di tabacco da masticare, dodici marchi di tabacco da fumo, e il marchio Camel top di vendita di sigarette.",0,0.907824665,10,1,9,,,1,0,1
We should ban conversion therapy,Dovremmo vietare la terapia di conversione,"In December 2016, Taiwan's highest health authority announced plans to ban Conversion Therapy, which aims to change a person's sexual orientation.",1,0.9,1,"Nel dicembre 2016, la più alta autorità sanitaria di Taiwan ha annunciato piani per vietare la Terapia di Conversione che mira a mutare l'orientamento sessuale di una persona.",1,1,7,7,0,1,1,7,7,0,"Nel dicembre 2016, la più alta autorità sanitaria di Taiwan ha annunciato i piani di vietare la Conversion Therapy, che mira a cambiare l'orientamento sessuale di una persona.",1,0.889066837,10,9,1,1,1,9,9,0
We should ban conversion therapy,Dovremmo vietare la terapia di conversione,"On August 1, 2016, Seattle voted to ban conversion therapy on minors.",1,1,1,"il primo agosto 2016, Seattle ha votato per vietare la terapia di conversione dei minori",1,1,7,7,0,1,1,7,7,0,Il 01 agosto 2016 Seattle ha votato per vietare la terapia di conversione sui minori.,1,0.943711993,10,9,1,1,1,9,8,1
We should ban media conglomerates,Dovremmo vietare i conglomerati dei media,Amroha has several active media groups which continuously give the populace Hindi news updates on Amroha: ,0,0.222222222,0,Amroha ha diversi media attivi che danno continuamente alla popolazione hindi notizie aggiornate sul luogo.,0,0.789225311,10,2,8,,,2,0,2,Amroha ha diversi gruppi di media attivi che danno continuamente le notizie di popolamento Hindi su Amroha: ,0,1,8,0,8,,,0,0,0
We should ban media conglomerates,Dovremmo vietare i conglomerati dei media,In Fine Style (1984) Sunset Records Money Man Skank (1984) Jammys One in a Million (1984) Greensleeves Great Hits of All Times (1985) Feel the Beat Greetings (1986) Power House Joint Favourites (1986) Greensleeves Level the Vibes (1987) Taxi Records Victory (1988) RAS 20 Super Hits (1990) Sonic Sounds One Big Family (1990) Power House Pick Your Choice (1993) VP Records Classics (1994) Outa!/Hightone Classics In Dub (1995) Outa!/Hightone Collection (1997) Tachyon (Japan) Half Pint (1997) VP Records Legal We Legal (1998) Artists Only! Closer to You (1999) Half Pint Music  Recollection (2000) Cornerstone R.A.S./Skunk Past to Present (2006) Ryff Music No Stress Express (2008) Half Pint Music/Essential/Universal Music Group Essential Roots Anthology (2008) Essential Media Group .,0,0,0,not translatable (all titles),0,1,7,0,7,,,0,0,0,In Fine Stile (1984) Sunset Records Money Man Skank (1984) Jammys One in a Million (1984) Greensleeves Great Hits of All Times (1985) Feel the Beat Greetings (1986) Greensleeves Level the Vibes (1987) RAS 20 Super Hits (1990) Sonic Sounds One Big Family (1990) Potenza a scelta (1993) VP Record Classics (1994) Outa! /Hightone Classics In Dub (1995) Outa! /Hightone Collection (1997) Tachyon (Giappone) Half Pint (1997) VP Records Leggi Legale (1998) Solo Artisti! Più vicino a Te (1999) Half Pint Music Recollection (2000) Cornerstone R.A.S. /Skunk Past to Present (2006) Ryff Music No Stress Express (2008) Half Pint Music / Essential / Universal Music Group Essential Roots Anthology (2008) Essential Media Group.,0,1,7,0,7,,,0,0,0
We should ban multi-level marketing,Dovremmo vietare il marketing multi - livello,"The Ministry of Commerce and Industry, has warned citizens of Saudi Arabia, of network marketing which is banned in their country, after receiving complaints about companies like Tvi, Qnet which rely on network marketing .",1,0.6,1,"Il Ministero del Commercio e dell'Industria ha messo in guardia i cittadini dell'Arabia Saudita dal network marketing, che è vietato nel loro paese, dopo aver ricevuto lamentele su aziende come Tvi, Qnet che si affidano a quel network.",1,0.713730573,10,7,3,1,1,7,7,0,"Il Ministero del Commercio e dell'Industria, ha avvertito i cittadini dell'Arabia Saudita, del marketing di rete vietato nel loro paese, dopo aver ricevuto reclami su aziende come Tvi, Qnet che si affidano al marketing di rete.",1,0.76594753,10,8,2,1,1,8,8,0
We should ban multi-level marketing,Dovremmo vietare il marketing multi - livello,"Critics have argued that the use of these and other different terms and ""buzzwords"" is an effort to distinguish multi-level marketing from illegal Ponzi schemes, chain letters, and consumer fraud scams.  ",1,0.727272727,1,"critici hanno discusso che l'uso di questi e altri termini e parole d'ordine in uno sforzo di differenziare multi level marketing da schemi illegai tipo Ponzi, lettere a catena e truffe fraudolente ai consumatori",0,0.525181048,10,4,6,1,1,4,4,0,"I critici hanno sostenuto che l'uso di questi e altri termini diversi e ""buzzwords"" è uno sforzo per distinguere il marketing multi - livello dagli schemi di Ponzi illegali, le lettere a catena e le truffe per truffe dei consumatori.  ",0,0.906898127,10,1,9,,,1,0,1
We should ban rodenticide,Dovremmo vietare il rodenticidio,Various pesticides such as rodenticides may cause secondary poisoning .,1,1,1,"Diversi pesticidi, come i rodenticidi, possono causare un avvelenamento secondario.",1,1,10,9,1,1,1,9,9,0,Vari pesticidi come rodenticidi possono causare un avvelenamento secondario.,1,1,7,7,0,1,1,7,7,0
We should ban rodenticide,Dovremmo vietare il rodenticidio,"2006 saw an increase in numbers, to a total of over 100, thought to be the result of pet owners' fears over avian flu; and a decline, attributed to people feeding them rat poison, which led to their numbers being reduced to around six.  ",0,0.3,1,"il 2006 vide un incremento, un totale di oltre cento, pensato di essere il risultato del numero proprietari di anmali domestici a temere l' influenza aviaria; e un declino, attribuito a coloro che li nutrivano con cibo inquuinato con veleno per topi, che porto' a quei numeri ridotti a sei circa.",1,0.528113034,10,5,5,1,1,5,5,0,"Il 2006 ha visto un aumento dei numeri, a un totale di oltre il 100, pensato per essere il risultato dei timori dei proprietari di animali sull'influenza aviaria; e un calo, attribuito alle persone che li nutre di veleno per topi, che ha portato i loro numeri a ridursi a circa sei.  ",0,0.56131082,10,4,6,1,1,4,3,1
We should ban the use of migrant workers,Dovremmo vietare l'uso dei lavoratori migranti,"Researchers at the Overseas Development Institute found that these migrant workers are often subject to harassment, violence, and discrimination during their journeys at their destinations and when they return home .",1,0.6,1,"I ricercatori dell'Overseas Development Institute hanno scoperto che questi lavoratori migranti sono spesso soggetti a molestie, violenza e discriminazione durante il viaggio di andata e ritorno.",1,0.801651353,10,8,2,1,1,8,8,0,"I ricercatori dell'Overseas Development Institute hanno scoperto che questi lavoratori migranti sono spesso soggetti a vessazioni, violenze e discriminazioni durante i loro viaggi nelle loro destinazioni e quando tornano a casa.",1,0.897707378,10,9,1,1,1,9,9,0
We should ban the use of migrant workers,Dovremmo vietare l'uso dei lavoratori migranti,"Other United Nations agencies have addressed migrant domestic work, with the United Nations Development Fund for Women (UNIFEM) attempting to facilitate dialogue between countries to establish agreements that recognize migrant workers' rights protection, and the United Nations Population Fund (UNFPA) releasing a report highlighting the gendered aspects of migration.  ",0,0.5,-1,"altre agenzie delle Nazioni unite hanno discusso del lavoro domestico dei migranti, con il Fondo per lo Sviluppo delle Donne delle Nazioni unite (UNIFEM) cercando di semplificare il dialogo tra i paesi per stabilire accordi che riconoscano la protezione dei diritti dei lavoratori migranti, e il Fondo delle Nazioni unite sulla Popolazione (UNFPA) rilasciando un rapporto che sottolinea gli aspetti di genere della migrazione.",0,0.550740293,10,5,5,-1,1,5,1,4,"Altre agenzie delle Nazioni Unite hanno affrontato il lavoro domestico dei migranti, con il Fondo per lo sviluppo delle Nazioni Unite per le donne (UNIFEM) che tenta di facilitare il dialogo tra i paesi per stabilire accordi che riconoscano la tutela dei diritti dei lavoratori migranti, e il Fondo delle Nazioni Unite per la popolazione (UNFPA) rilasciando un rapporto che evidenzino gli aspetti di genere della migrazione.  ",0,0.635122405,10,4,6,,,4,0,4
We should cancel the pledge of allegiance to the flag,Dovremmo annullare la promessa di fedeltà alla bandiera,About half of the states encourage schools to recite the Pledge of Allegiance to the flag .  ,1,0.75,-1,Circa la metà degli Stati incoraggia le scuole a recitare il Giuramento di fedeltà alla bandiera.  ,1,0.719410546,10,8,2,-1,1,8,0,8,Circa la metà degli stati incoraggia le scuole a recitare la Promessa di Allegianza alla bandiera.  ,1,0.58496107,10,6,4,-1,1,6,0,6
We should cancel the pledge of allegiance to the flag,Dovremmo annullare la promessa di fedeltà alla bandiera,"In 2009, a Montgomery County, Maryland, teacher berated and had school police remove a 13-year-old girl who refused to say the Pledge of Allegiance in the classroom.",0,0.2,0,"nel 2009, nella contea di Montgomery in Maryland, un insegnante rimprovero' una ragazza tredicenne facendola rimuovere dalla polizia perche' si rifiuto' di cantare l'inni nazionale",1,0.612958097,10,6,4,1,1,6,4,2,"Nel 2009 una contea di Montgomery, il Maryland, l'insegnante berò e la polizia scolastica rimuoveva una ragazza di 13 anni che si rifiutò di dire la Promessa di Allegianza in aula.",1,0.510580709,10,5,5,1,1,5,2,3
We should close landfills,Dovremmo chiudere le discariche,The mayor of the city was opposed to the landfill because of the amount of toxic waste in it and the threat to the local water supply.  ,1,1,1,Il sindaco della città si è opposto alla discarica a causa della quantità di rifiuti tossici in essa contenuti e della minaccia per l'approvvigionamento idrico locale.  ,1,1,7,7,0,1,1,7,7,0,Il sindaco della città era contrario alla discarica a causa della quantità di rifiuti tossici in esso contenuti e della minaccia per l'approvvigionamento idrico locale.  ,1,0.786774216,10,8,2,1,1,8,8,0
We should close landfills,Dovremmo chiudere le discariche,"Recycling computing equipment can keep harmful materials such as lead, mercury, and hexavalent chromium out of landfills, and can also replace equipment that otherwise would need to be manufactured, saving further energy and emissions.",0,0.105263158,0,"il riciclaggio delle apparecchiature informatiche puo' contenere materiali dannosi come piombo, mercurio, e cromo esavalente dalle discariche, e puo' anche sostituire parti che altrimenti dovrebbero essere costruite, risparmiando ulteriore energia ed emissioni.",1,0.56484658,10,5,5,1,1,5,5,0,"Le apparecchiature di calcolo del riciclo possono mantenere materiali dannosi come piombo, mercurio e cromo esavalente su discariche, e possono anche sostituire apparecchiature che altrimenti avrebbero bisogno di essere fabbricate, risparmiando ulteriori energie ed emissioni.",0,0.510665057,10,5,5,1,1,5,5,0
We should disband Planned Parenthood,Dovremmo sciogli Planned Parenthood, She supports organizations including Planned Parenthood and causes related to environmental protection and LGBTQ rights .,1,0.6,-1,Lei sostiene le organizzazioni che includono la genitorialità pianificata e le cause legate alla protezione dell'ambiente e ai diritti LGBTQ .,0,0.632688851,10,4,6,-1,1,4,0,4, Supporta le organizzazioni tra cui Planned Parenthood e le cause legate alla protezione ambientale e ai diritti LGBTQ.,0,1,7,0,7,,,0,0,0
We should disband Planned Parenthood,Dovremmo sciogli Planned Parenthood,A US District Court judge ruled in favor of Planned Parenthood.,1,0.7,-1,un giudice della Corte Distrettuale si e' posto in favore della genitorialita' pianificata,1,1,10,10,0,-1,1,10,1,9,Un giudice della Corte distrettuale degli Stati Uniti ha stabilito a favore di Planned Parenthood.,1,1,7,7,0,-1,1,7,0,7
We should disband the G20,Dovremmo sciogli il G20,"(BBC) ISD (talk) 15:39, 2 April 2009 (UTC) ""G20 strikes trillion-dollar crisis deal.""",0,0.1,0,"(BBC) ISD (talk) 15:39, 2 aprile 2009 (UTC) ""il G20 sigla un accordo da trilioni di dollari.""",0,1,7,0,7,,,0,0,0,"(BBC) ISD (talk) 15.39, 02 aprile 2009 (UTC) ""G20 colpisce l'accordo di crisi trillio-dollaro"".",0,1,7,0,7,,,0,0,0
We should disband the G20,Dovremmo sciogli il G20,"PwC publishes the Low Carbon Economy Index which tracks the extent to which the G20 countries are reducing carbon intensity, which is emissions linked to energy usage .",0,0,0,"PwC pubblica il Low Carbon Economy Index che traccia la misura in cui i paesi del G20 stanno riducendo l'intensità di carbonio, ovvero le emissioni legate all'uso di energia.",0,0.716270337,10,3,7,-1,1,3,0,3,"PwC pubblica il Low Carbon Economy Index che traccia la misura in cui i paesi del G20 stanno riducendo l'intensità di carbonio, ovvero le emissioni legate all'utilizzo dell'energia.",0,0.882546781,10,1,9,-1,1,1,0,1
We should disband the United Nations Security Council,Dovremmo sciogli il Consiglio di Sicurezza delle Nazioni Unite,"In June 2013, Barack Obama and Vladimir Putin agreed to install a secure Cyberwar-Hotline providing ""a direct secure voice communications line between the US cybersecurity coordinator and the Russian deputy secretary of the security council, should there be a need to directly manage a crisis situation arising from an ICT security incident"" (White House quote) .  ",0,0,0,"Nel giugno 2013, Barack Obama e Vladimir Putin hanno concordato di installare una Cyberwar-Hotline sicura che fornisca ""una linea di linea diretta di comunicazione vocale sicura tra il coordinatore della sicurezza informatica degli Stati Uniti e il vice segretario russo del consiglio di sicurezza, nel caso ci fosse la necessità di gestire direttamente una situazione di crisi derivante da un incidente di sicurezza ICT"" (citazione della Casa Bianca).",0,0.924096481,10,1,9,,,1,1,0,"Nel giugno 2013 Barack Obama e Vladimir Putin hanno accettato di installare una Cyberwar-Hotline sicura che fornisca ""una linea di comunicazione vocale sicura diretta tra il coordinatore della cybersecurity statunitense e il vice segretario russo del consiglio di sicurezza, dovrebbe esserci la necessità di gestire direttamente una situazione di crisi derivante da un incidente di sicurezza ICT"" (citazione della Casa Bianca).  ",0,0.946815783,11,1,10,,,1,1,0
We should disband the United Nations Security Council,Dovremmo sciogli il Consiglio di Sicurezza delle Nazioni Unite,"The UK Foreign Secretary William Hague called for an urgent session of the UNSC following Friday's ""appalling crime"" at Houla.",0,0.1,0,il segretario agli affari esteri William Hague ha richiesto una sessione urgente del UNSC dopo il terriibile crimine ad Houla,0,1,7,0,7,,,0,0,0,"Il ministro degli Esteri britannico William Hague ha chiesto una sessione urgente dell'UNSC dopo il ""crimine appagante"" del venerdì a Houla.",0,1,7,0,7,,,0,0,0
We should end child benefits,Dovremmo porre fine ai benefici per i bambini,Umar also introduced a child benefit and pensions for the children and the elderly .,0,0.5,-1,Umar ha anche introdotto un assegno familiare e pensioni per i bambini e gli anziani.,0,0.595913313,10,5,5,-1,1,5,0,5,Umar ha anche introdotto un beneficio per i bambini e le pensioni per i bambini e gli anziani.,0,0.536273303,10,5,5,-1,1,5,0,5
We should end child benefits,Dovremmo porre fine ai benefici per i bambini,"The Cook Islands Party launched their campaign on October 8, promising an increased child benefit, a $1000 ""baby bonus"", water tanks for every household and to address the cost of living.",1,0.666666667,-1,"il partito Cook Island ha lanciato la sua campagna l'otto di ottobre promettendo un aumentato beneficio sui figli, un baby bonus di $1000, serbatoi d'acqua per ogni famiglia per fronteggiare il costo della vita",1,1,10,10,0,-1,0.70184387,10,1,9,"Il Partito delle Isole Cook ha lanciato la loro campagna il 08 ottobre, promettendo un aumento dei benefici per i bambini, un ""baby bonus"" del $1000, i serbatoi d'acqua per ogni famiglia e per affrontare il costo della vita.",1,0.773799471,10,8,2,-1,1,8,0,8
We should end privatization,Dovremmo terminare le privatizzazioni,Professor Mwandosya has also been involved in state sector reforms including privatisation on and in the crafting of Tanzanians long-term development vision (Vision 2025).  ,1,0.8,-1,"Il professor Mwandosya è stato anche coinvolto in riforme del settore statale, tra cui la privatizzazione e la realizzazione di una visione di sviluppo a lungo termine per i tanzaniani (Vision 2025).",0,0.688999936,10,4,6,,,4,1,3,Il professor Mwandosya è stato coinvolto anche nelle riforme del settore statale tra cui la privatizzazione su e nell'artigianato della visione di sviluppo a lungo termine della Tanzania (Vision 2025).  ,0,0.905377918,10,1,9,,,1,0,1
We should end privatization,Dovremmo terminare le privatizzazioni,On 24 March 2015 the Central Jakarta District Court ruled that the terms of the privatisation of Jakarta's water violated the common right to water guaranteed by Article 33 of the Constitution of Indonesia.,1,1,1,il 24 marzo 2015 la Corte Distrettuale Centrale di Jakarta stabili' che i termini della privatizzazione dell'acqua di Jakarta violavano il diritto comune all'acqua garantito dall'articolo 33 della costituzione dell' Indonesia.,1,0.903017226,10,9,1,1,1,9,9,0,Il 24 marzo 2015 la Corte distrettuale di Jakarta ha stabilito che i termini della privatizzazione dell'acqua di Giacarta violavano il diritto comune all'acqua garantito dall'articolo 33 della Costituzione dell'Indonesia.,1,0.883694482,10,9,1,1,1,9,9,0
We should end the use of bailouts,Dovremmo porre fine all'uso dei salvataggi,"On September 30, 2008, as LDP General Affairs Council Chairman, Takashi Sasagawa suggested that the US House of Representatives rejected the bailout plan because House Speaker Nancy Pelosi is a woman .",1,0.6,1,"Il 30 settembre 2008, in qualità di Presidente del Consiglio Affari Generali del LDP, Takashi Sasagawa ha suggerito che la Camera dei Rappresentanti degli Stati Uniti ha respinto il piano di salvataggio perché la Presidente della Camera Nancy Pelosi è una donna.",0,0.863048659,10,2,8,1,1,2,1,1,"Il 30 settembre 2008, come presidente del Consiglio Affari generali della LDP, Takashi Sasagawa ha suggerito che la Camera dei Rappresentanti degli Stati Uniti ha respinto il piano di salvataggio perché la presidente della Camera Nancy Pelosi è una donna.",0,0.734236734,10,3,7,1,1,3,2,1
We should end the use of bailouts,Dovremmo porre fine all'uso dei salvataggi,"In October 2008, the Labour Government of the UK introduced a bank rescue package as a response to the Financial crisis of 2007-2010.",1,0.6,-1,"nell'ottobre 2008, il governo laburista del Regno unito ha introdotto un pacchetto di salvataggio bancario in risposta della crisi finanziaria del 2007-2010",1,0.817411708,10,8,2,-1,1,8,0,8,"Nell'ottobre 2008, il governo laburista del Regno Unito ha introdotto un pacchetto di salvataggio bancario come risposta alla crisi finanziaria del 2007-2010.",1,0.793781852,10,8,2,-1,1,8,1,7
We should end the use of mass surveillance,Dovremmo porre fine all'uso della sorveglianza di massa,Another criticism is that increasing mass surveillance could lead to the development of a surveillance state or an electronic police state where civil liberties are infringed or political dissent is undermined by COINTELPRO-like programs.,1,0.916666667,1,Un'altra critica è che l'aumento della sorveglianza di massa potrebbe portare allo sviluppo di uno stato di sorveglianza oppure di polizia elettronica in cui le libertà civili sono violate o il dissenso politico minato da programmi simili a COINTELPRO.,1,1,7,7,0,1,1,7,7,0,Un'altra critica è che l'aumento della sorveglianza di massa potrebbe portare allo sviluppo di uno stato di sorveglianza o di uno stato di polizia elettronica dove le libertà civili vengono violate o il dissenso politico è minato dai programmi COINTELPRO.,1,1,8,8,0,1,1,8,8,0
We should end the use of mass surveillance,Dovremmo porre fine all'uso della sorveglianza di massa,"In 2013, ALG joined with over 100 civil liberties groups including the Electronic Frontier Foundation and the American Civil Liberties Union to oppose mass surveillance by the National Security Agency (NSA) in the wake of whistle blower Edward Snowden's publication of classified information revealing domestic telecommunications companies collecting the phone records of American citizens.",1,0.8,1,"nel 2013, ALG si e' unita con oltre 100 gruppi di liberta' civili compreso il Electronic Frontier Foundation e American Civil Liberties Union per opporre la sorveglianza di massa del National Security Agency (NSA) al sorgere della pubblicazione di informazioni segrete della talpa Edward Snowden che rivelavano telefonate di compagnie telefoniche nazionali",1,1,7,7,0,1,1,7,7,0,Nel 2013 ALG ha aderito con oltre 100 gruppi di libertà civili tra cui la Electronic Frontier Foundation e l'American Civil Liberties Union per opporsi alla sorveglianza di massa da parte della National Security Agency (NSA) sulla scia della pubblicazione di whistle blower Edward Snowden di informazioni classificate che rivelano le aziende di telecomunicazioni domestiche che raccolgono i tabulati telefonici dei cittadini americani.,1,1,7,7,0,1,1,7,7,0
We should end the use of public housing,Dovremmo porre fine all'uso degli alloggi pubblici,"At its south-eastern end is the Glebe Estate, an area of Housing Commission properties purchased by the government of Gough Whitlam as a massive urban renewal project to provide public housing for the needy.",0,0.5,-1,"Alla sua estremità sud-est si trova la Glebe Estate, un'area di proprietà della Housing Commission acquistata dal governo di Gough Whitlam come massiccio progetto di rinnovamento urbano per fornire alloggi pubblici ai bisognosi.",0,0.815932599,10,2,8,,,2,0,2,"Al suo fine sud - est si trova la Glebe Estate, una zona di Housing Commission proprietà acquistata dal governo di Gough Whitlam come un massiccio progetto di rinnovamento urbano per fornire alloggi pubblici ai bisognosi.",0,0.714673829,12,3,9,-1,1,3,0,3
We should end the use of public housing,Dovremmo porre fine all'uso degli alloggi pubblici,"Richard J. Mayer was the Principal Investigator on the projects of developing IDEF3, IDEF4 en IDEF6.",0,0,0,"Richard J. Mayer e' stato l'investigatore principale dello sviluppo dei progetti IDEF3, IDEF4 e IDEF6.",0,1,7,0,7,,,0,0,0,"Richard J. Mayer è stato il Principal Investigator sui progetti di sviluppo di IDEF3, IDEF4 en IDEF6.",0,1,7,0,7,,,0,0,0
We should end the use of solitary confinement,Dovremmo porre fine all'uso del confinamento solitario,Proponents of solitary confinement propound that solitary confinement can improve the safety of inmates and prison staff.,1,1,-1,I sostenitori dell'isolamento sostengono che questo può migliorare la sicurezza dei detenuti e del personale carcerario.,1,0.739059505,11,7,4,-1,1,7,1,6,Sostenitori del confinamento solitario prosterono che il confinamento solitario può migliorare la sicurezza dei detenuti e del personale carcerario.,1,1,7,7,0,-1,1,7,0,7
We should end the use of solitary confinement,Dovremmo porre fine all'uso del confinamento solitario,"Human Rights Watch also found that prolonged use of solitary confinement can violate the 8th amendment, and in some cases be considered torture.",1,1,1,"human right watch ha scoperto che l' uso di confinamento prolungato puo' violare l'ottavo emendamento, ed in alcuni casi e' considerato tortura",1,1,7,7,0,1,1,7,7,0,"Human Rights Watch ha anche scoperto che un uso prolungato di confinamento solitario può violare l'ottavo emendamento, e in alcuni casi è considerata una tortura.",1,1,7,7,0,1,1,7,7,0
We should end the use of traffic enforcement cameras,Dovremmo porre fine all'uso delle telecamere di applicazione del traffico,"On April 4, 2009, Senate Bill 277 authorizing the use of speed cameras in school zones in every county in the state andin highway work zones on expressways, passed the Maryland State Senate and House of Delegates .",1,1,-1,"Il 4 aprile 2009, la legge 277 del Senato che autorizza l'uso degli autovelox nelle zone scolastiche di ogni contea dello stato e nelle zone di lavoro sulle autostrade, è stata approvata dal Senato e dalla Camera dei delegati dello Stato del Maryland.",0,0.58371911,10,5,5,,,5,1,4,"Il 04 aprile 2009, il Senato Bill 277 autorizzava l'uso di telecamere di velocità nelle zone scolastiche in ogni contea dello Stato e nelle zone di lavoro autostradali sulle autostrade, ha superato il Senato dello Stato del Maryland e la Camera dei Delegati.",0,0.604482967,10,4,6,-1,1,4,0,4
We should end the use of traffic enforcement cameras,Dovremmo porre fine all'uso delle telecamere di applicazione del traffico,"In March 2006, the Jefferson County Court of Common Pleas ruled that the city ordinance of supporting the speed camera program was illegal and unconstitutional.",1,1,1,"nel marzo 2006 la corte di Jefferson County of common plea, ordino' che le ordinaze cittadine sostenitrici dei programmi delle telecamere per la velocita' erano illegali e anticostituzionali.",1,1,10,10,0,1,0.66513415,10,9,1,"Nel marzo del 2006, il Tribunale della contea di Jefferson ha stabilito che l'ordinanza comunale di sostenere il programma della telecamera di velocità era illegale e incostituzionale.",1,1,7,7,0,1,1,7,7,0
We should fight environmental degradation,Dovremmo combattere la degradazione ambientale,The UN Millennium Ecosystem Assessment determined that environmental degradation is more prominent within wetland systems than any other ecosystem on Earth.,1,0.8,1,La Valutazione degli Ecosistemi del Millennio delle Nazioni Unite ha stabilito che il degrado ambientale è più evidente nei sistemi delle zone umide che in qualsiasi altro ecosistema sulla Terra.,0,0.828457896,10,3,7,,,3,3,0,L'Onu Millennium Ecosystem Assessment ha stabilito che la degradazione ambientale è più prominente all'interno dei sistemi umidi rispetto a qualsiasi altro ecosistema sulla Terra.,0,0.823192727,10,2,8,1,1,2,2,0
We should fight environmental degradation,Dovremmo combattere la degradazione ambientale,"Lack of regulations has led to unbridled and destructive logging that has caused environmental damage such as soil erosion, river contamination, and increased flooding.",1,0.7,1,"la mancanza di normative ha portato a disboscamenti sfrenati e distruttivi che hanno causato danni ambientali come erosione del suolo, contaminazione dei fiumi, e aumento delle innondazioni..",1,1,7,7,0,1,1,7,7,0,"La mancanza di normative ha portato a una registrazione sfrenata e distruttiva che ha causato danni ambientali come l'erosione del suolo, la contaminazione del fiume e l'aumento delle alluvioni.",1,1,7,7,0,1,1,7,7,0
We should fight illegal logging,Dovremmo combattere la registrazione illegale,"The EU-FLEGT Programme ('Forest Law Enforcement, Governance and Trade') aims to reduce illegal logging by strengthening the sustainability and legality of forest management, improving forest governance and promoting trade in legally produced timber .",1,1,1,"Il programma UE-FLEGT (""Applicazione delle normative, governance e commercio nel settore forestale"") mira a ridurre il disboscamento illegale rafforzando la sostenibilità e la legalità della gestione delle foreste, migliorando la governance e promuovendo il commercio di legname prodotto in modo legale.",1,0.668392029,10,7,3,1,1,7,7,0,"Il Programma UE - FLEGT (""Forest Law Enforcement, Governance and Trade"") mira a ridurre la registrazione illegale rafforzando la sostenibilità e la legalità della gestione delle foreste, migliorando la governance delle foreste e promuovendo il commercio di legname legalmente prodotto.",1,1,7,7,0,1,1,7,7,0
We should fight illegal logging,Dovremmo combattere la registrazione illegale,Slash-and-burn of forest for agricultural cultivation and illegal logging also has contributed to the degradation of some parts of the protected area.,1,1,1,anche il tagliare e bruciare delle foreste ha contribuito alla degradazione di alcune parti dell'area protetta.,1,0.717048256,10,7,3,1,1,7,7,0,La fascia - e - burn of forest per la coltivazione agricola e la registrazione illegale hanno contribuito anche alla degradazione di alcune parti dell'area protetta.,1,0.724361156,10,7,3,1,1,7,7,0
We should fight sedentary lifestyle,Dovremmo combattere lo stile di vita sedentario,"Noncommunicable diseases, partly due to a lack of exercise, are currently the greatest public health problem in most countries around the world .",1,0.9,1,"Le malattie non trasmissibili, in parte dovute alla mancanza di esercizio fisico, sono attualmente il più grande problema di salute pubblica nella maggior parte dei paesi.",1,1,10,9,1,1,1,9,9,0,"Le malattie non trasmissibili, in parte dovute a mancanza di esercizio fisico, sono attualmente il più grande problema di salute pubblica nella maggior parte dei paesi del mondo.",1,0.906265747,10,9,1,1,1,9,9,0
We should fight sedentary lifestyle,Dovremmo combattere lo stile di vita sedentario,Physical inactivity is believed to contribute to cancer risk not only through its effect on body weight but also through negative effects on immune system and endocrine system.,1,1,1,l'inattivita' fisica sembra contribuire al rischio di cancro non solo a causa dell'effetto di aumento di peso ma anche attraverso effetti negativi sul sistema immunitario e sul sistema endocrino.,1,1,7,7,0,1,1,7,7,0,Si ritiene che l'inattività fisica possa contribuire al rischio di cancro non solo attraverso il suo effetto sul peso corporeo ma anche attraverso effetti negativi sul sistema immunitario e sul sistema endocrino.,1,1,8,8,0,1,1,8,8,0
We should fight the gender pay gap,Dovremmo combattere il divario retribuito di genere,"After UC Davis published its Study of California Women Business Leaders in November 2006, some San Jose Mercury News readers dismissed the possibility that sexism contributed in making Silicon Valley's leadership gender gap the highest in the state.",0,0.2,0,"Dopo che UC Davis ha pubblicato il suo Study of California Women Business Leaders nel novembre 2006, alcuni lettori del San Jose Mercury News hanno respinto la tesi secondo cui il sessismo avrebbe contribuito a rendere il divario di genere nella Silicon Valley il più alto dello stato.",1,0.650235839,10,7,3,-1,1,7,1,6,"Dopo che UC Davis ha pubblicato il suo Study of California Women Business Leaders nel novembre 2006, alcuni lettori di San Jose Mercury News hanno respinto la possibilità che il sessismo abbia contribuito a rendere il gender gap di leadership di Silicon Valley il più alto dello stato.",0,0.546079523,10,5,5,1,1,5,1,4
We should fight the gender pay gap,Dovremmo combattere il divario retribuito di genere,"In her position as the Director of the Workplace Gender Equality Agency, Lyons has advocated to close the gender pay gap and break down occupational gender segregation in Australia.",1,1,1,"nella sua posizione di direttore dll' Agenzia di Uguaglianza Sessuale nei Posti di Lavoro, Lyons ha sostenuto di abolire la discriminazione di paga per la differenza dei sessi, e di porre fine alla segregazione sessuale in Australia.",1,1,7,7,0,1,1,7,7,0,"Nella sua posizione di direttore del Workplace Gender Equality Agency, Lyons ha auspicato di chiudere il divario retribuito di genere e di abbattere la segregazione occupazionale occupazionale in Australia.",1,1,7,7,0,1,1,7,7,0
We should further exploit enhanced oil recovery,Dovremmo sfruttare ulteriormente il recupero del petrolio migliorato,In 2007 SNF won the design-build and supply PDO contract (Petroleum Development of Oman) for Enhanced Oil Recovery.,0,0.5,1,"Nel 2007, SNF si è aggiudicata il contratto PDO (Petroleum Development of Oman - Sviluppo petrolifero dell'Oman) per l'Enhanced Oil Recovery (processi di recupero assistito del petrolio o terziari)",0,0.915862179,10,1,9,,,1,1,0,Nel 2007 SNF ha vinto il contratto di progettazione e fornitura DOP (Petroleum Development of Oman) per Enhanced Oil Recovery.,0,1,9,0,9,,,0,0,0
We should further exploit enhanced oil recovery,Dovremmo sfruttare ulteriormente il recupero del petrolio migliorato,"Reservoir Engineering: Experimental studies on novel methods for improved oil recovery, like chemical flooding, non-hydrocarbon gas flooding and microbial flooding  Development of improved methods for numerical simulation of enhanced oil recovery processes in conventional, fractured and heterogeneous reservoirs  Development of improved techniques for interpretation of well tests, specially related to compressible reservoirs  Development of phase-behaviour software for non-hydrocarbon injection gases for enhanced oil recovery .  ",0,0.4,1,"ingeneria dei giacimenti: studi sperimentali sui nuovi metodi per migliorare il recupero di petrolio, come l'innondazione chimica, innondazione di gas non idrocarburi e sviluppo di innondazioni microbiche, metodi migliorati per simulazione numerica di processi di recupero di oli potenziati in serbatoi convenzionali, fratturati ed emogenei, sviluppo di tecniche migliorate per la verifica prove dei pozzi relativi in special modo a serbatoi comprimibili, sviluppo di software a comportamento di fase per gas di iniezione non idrocarburici per un recupero di oli potenziati.",0,0.645286783,10,4,6,1,1,4,4,0,"Reservoir Engineering: Experimental studies on novel methods for migliorata oil recovery, like inondazione chimica, alluvione di gas non - idrocarburi e alluvione microbica Sviluppo di metodi migliorati per la simulazione numerica di processi di recupero del petrolio potenziati in serbatoi convenzionali, fratturati ed eterogenei Sviluppo di tecniche migliorate per l'interpretazione di ben test, appositamente correlati a serbatoi compressibili Sviluppo di software di comportamento a base di gas non idrocarburico per recupero del petrolio migliorato.  ",1,0.601205945,10,6,4,1,1,6,6,0
We should further exploit filibusters,Dovremmo sfruttare ulteriormente i filibusti,"In 2005, a group of Republican senators led by Majority Leader Bill Frist proposed having the presiding officer, Vice President Dick Cheney, rule that a filibuster on judicial nominees was unconstitutional, as it was inconsistent with the President's power to name judges with the advice and consent of a simple majority of senators .",1,0.9,-1,"Nel 2005, un gruppo di senatori repubblicani guidati dal leader della maggioranza Bill Frist ha proposto che il presidente, il vice presidente Dick Cheney, dichiarasse incostituzionale l'ostruzionismo nei confronti dei candidati alla giustizia, in quanto incompatibile con il potere del presidente di nominare i giudici con il consiglio e il consenso della maggioranza semplice dei senatori.",0,0.714362552,10,4,6,,,4,1,3,"Nel 2005, un gruppo di senatori repubblicani guidati da Majority Leader Bill Frist propose di avere il presidente uscente, il vicepresidente Dick Cheney, governare che un filibuster sulle nomine giudiziarie fosse incostituzionale, in quanto era incoerente con il potere del Presidente di nominare i giudici con la consulenza e il consenso di una semplice maggioranza di senatori.",1,0.749397331,10,7,3,-1,0.528995613,7,2,5
We should further exploit filibusters,Dovremmo sfruttare ulteriormente i filibusti,The Alliance subsequently held a third signature campaign from 9 May 2015 to 17 May 2015 to amass support for democracy in Hong Kong and the 2014-15 Hong Kong electoral reform () and to voice opposition to the ongoing filibustering in Hong Kong ().,1,0.714285714,-1,l'alleanza ha succesivamente tenuto una terza campagna di firme dal 9 maggio 2015 al 17 maggio 2015 per accumulare sostegno per la democrazia in Hong Kong e alla riforma elettorale di Hong Kong 2014-15 () e per dare voce all' opposizione all' ostruzionismo ad Hong Kong ().,0,0.826028609,10,2,8,1,1,2,1,1,L'Alleanza ha successivamente tenuto una terza campagna di firma dal 09 maggio 2015 al 17 maggio 2015 per ammanare il sostegno alla democrazia a Hong Kong e la riforma elettorale di Hong Kong 2014 - 15 () e all'opposizione vocale alla filiera in corso a Hong Kong ().,0,0.906898127,10,1,9,,,1,1,0
We should further exploit genetic engineering,Dovremmo sfruttare ulteriormente l'ingegneria genetica,..that the immunology professor Mary Collins studies ways to use genetically engineered HIV as a vaccine?,0,0.1,0,..che la professoressa di immunologia Mary Collins studia modi di usare il vaccino HIV geneticamente modificato?,0,1,7,0,7,,,0,0,0,.. che la professoressa di immunologia Mary Collins studi modi per usare l'HIV geneticamente ingegnerizzato come vaccino?,0,0.900315772,10,1,9,,,1,1,0
We should further exploit genetic engineering,Dovremmo sfruttare ulteriormente l'ingegneria genetica,"According to Klein Lankhorst of Bio Solar Cells, genetic engineering could vastly improve algae fuel efficiency as algae can be modified to only build short carbon chains instead of long chains of carbohydrates .",1,1,1,"Secondo Klein Lankhorst di Bio Solar Cells, l'ingegneria genetica potrebbe migliorare notevolmente l'efficienza del carburante delle alghe poiché queste ultime possono essere modificate per costruire solo brevi catene di carbonio invece di lunghe catene di carboidrati.",1,1,7,7,0,1,1,7,7,0,"Secondo Klein Lankhorst di Bio Solar Cells, l'ingegneria genetica potrebbe migliorare enormemente l'efficienza di alghe come alghe possono essere modificate per costruire solo catene di carbonio brevi invece di lunghe catene di carboidrati.",1,1,7,7,0,1,1,7,7,0
We should further exploit mixed-use development,Dovremmo sfruttare ulteriormente lo sviluppo mixato,Mohammed Bin Rashid City is a planned mixed-use development.,0,0.5,1,Mohammed Bin Rashid City è un progetto di sviluppo ad uso misto.,0,0.91866674,10,2,8,,,2,2,0,Mohammed Bin Rashid City è uno sviluppo programmato a uso misto.,0,1,7,0,7,,,0,0,0
We should further exploit mixed-use development,Dovremmo sfruttare ulteriormente lo sviluppo mixato,"The framework proposed a mixed development is proposed, including the addition of new housing (public and private), community facilities, non-residential commercial development and retail.  ",1,0.6,1,"il quadro propose uno svilupp misto, compreso l'aggiunta di nuove abitazioni (pubbliche e private) strutture comunitarie, sviluppi commerciali non residenziali",1,0.817411708,10,8,2,1,1,8,8,0,"Il quadro proposto si propone uno sviluppo misto, tra cui l'aggiunta di nuovi alloggi (pubblici e privati), strutture di comunità, sviluppo commerciale non residenziale e retail.  ",1,0.723527713,10,7,3,1,1,7,7,0
We should increase consumer protection,Dovremmo aumentare la protezione dei consumatori,"Under the system, non-food and pharmaceutical products can be withdrawn from Caricom markets and action taken to ensure that regional and international manufacturers address consumer safety concerns .  ",1,0.777777778,1,"In base al sistema, i prodotti non alimentari e farmaceutici possono essere ritirati dai mercati Caricom ed è possibile intraprendere azioni per garantire che i produttori regionali e internazionali affrontino i problemi di sicurezza dei consumatori.  ",1,0.541519913,10,5,5,1,1,5,5,0,"Nell'ambito del sistema, i prodotti non alimentari e farmaceutici possono essere ritirati dai mercati di Caricom e intervenire per garantire che i produttori regionali e internazionali affronti le preoccupazioni per la sicurezza dei consumatori.  ",1,0.596199487,10,6,4,1,1,6,6,0
We should increase consumer protection,Dovremmo aumentare la protezione dei consumatori,"As a presidential candidate in 2015, Bush has proposed eliminating various consumer protection and food safety regulations, and imposing a freeze on new regulations.",1,0.8,-1,"come candidato presidenziale nel 2015, Bush propose di eliminare varie protezioni per il consumatore e regole sulla sicurezza alimentare, imponendo un blocco a nuove regole",1,0.904821088,10,9,1,-1,1,9,0,9,"Come candidato alle presidenziali nel 2015, Bush ha proposto di eliminare varie normative in materia di protezione dei consumatori e di sicurezza alimentare, e di imporre un congelamento ai nuovi regolamenti.",1,0.716798857,10,7,3,-1,1,7,0,7
We should increase environmental protection,Dovremmo aumentare la protezione ambientale,"The mission of the Institute is to ""conduct interdisciplinary research and partner with stakeholders to produce solutions that advance environmental protection, economic development, and social equity-in California, nationally, and internationally."" .  ",1,0.8,1,"La missione dell'Istituto è quella di ""condurre ricerche interdisciplinari e collaborare con le parti interessate per produrre soluzioni che promuovano la protezione dell'ambiente, lo sviluppo economico e l'equità sociale in California, a livello nazionale e internazionale"". ",1,0.550356902,10,6,4,1,1,6,6,0,"La missione dell'Istituto è quella di ""condurre ricerche interdisciplinari e partner con gli stakeholder per produrre soluzioni che anticipino la protezione ambientale, lo sviluppo economico e l'equità sociale - in California, a livello nazionale e internazionale"".  ",1,0.586846004,10,6,4,1,1,6,6,0
We should increase environmental protection,Dovremmo aumentare la protezione ambientale,"In 1974 he drafted The Nobel Laureates Declaration on the Survival of Mankind, signed by 78 Nobel Laureates advocating support for environmental protection and humanitarian leadership.",1,0.6,1,"nel 1974 ha redatto la dichiarazione sui premi Nobel per la sopravvivenza del genere umano, firmata da 78 premi Nobel per il sostegno della protezione ambientale e alla conduzione umanitarria",1,1,7,7,0,1,1,7,7,0,"Nel 1974 ha redatto The Nobel Laureates Declaration on the Survival of Mankind, firmato da 78 Nobel per la promozione della protezione ambientale e della leadership umanitaria.",1,0.892753473,10,9,1,1,1,9,9,0
We should increase the use of artificial insemination,Dovremmo aumentare l'uso dell'inseminazione artificiale,"Other topics were the behaviour of medical doctors, facing pain and death, sterilisation, genetics, artificial insemination, painless child birth, the multiple moral aspects of developing medical technologies, morality in applied psychology, moral limits to medical research and treatment, and cancer treatment of children, and more.",0,0,0,"Altri argomenti sono stati il comportamento dei medici, il dolore e la morte, la sterilizzazione, la genetica, l'inseminazione artificiale, il parto indolore, i molteplici aspetti morali dello sviluppo delle tecnologie mediche, la moralità nella psicologia applicata, i limiti morali della ricerca e del trattamento medico, il trattamento del cancro dei bambini e altro ancora.",0,1,7,0,7,,,0,0,0,"Altri argomenti sono stati il comportamento dei medici medici, affrontando il dolore e la morte, la sterilizzazione, la genetica, l'inseminazione artificiale, la nascita del bambino indolore, i molteplici aspetti morali dello sviluppo delle tecnologie mediche, la morale nella psicologia applicata, i limiti morali alla ricerca medica e il trattamento del cancro dei bambini, e altro ancora.",0,1,7,0,7,,,0,0,0
We should increase the use of artificial insemination,Dovremmo aumentare l'uso dell'inseminazione artificiale,The human practice of mating and artificially inseminating domesticated animals is part of animal husbandry.  ,1,0.6,1,la pratica umana dell' accoppiamento ed inseminazione artificiale suigli animali domestici fa parte dell' allevamento animale.,0,0.56886974,10,4,6,1,1,4,4,0,La pratica umana di accoppiamento e inseminazione artificialmente degli animali addomesticati fa parte dell'allevamento di animali.  ,0,0.542854448,10,5,5,1,1,5,5,0
We should increase the use of background checks,Dovremmo aumentare l'utilizzo dei controlli di fondo,"On January 16, 2016 Christie said: I don't support background checks for every gun sale .",1,1,-1,Il 16 gennaio 2016 Christie ha dichiarato: non sono a favore delle verifiche sui precedenti penali per ogni vendita di armi.,1,0.782440398,10,8,2,-1,1,8,0,8,Il 16 gennaio 2016 Christie ha detto: non sostengo controlli di fondo per ogni vendita di armi.,1,0.730711642,10,7,3,-1,0.66513415,7,1,6
We should increase the use of background checks,Dovremmo aumentare l'utilizzo dei controlli di fondo,Studies showed that over 85% of those questioned supported national background checks into the mental health records of citizens attempting to purchase a gun.,1,1,1,studi hanno dimostrato che oltre 85% degli intervistati hanno supportato i controlli a sfondo nazionale nei registri di salute mentale dei cittadini intenzionati ad acquistare un'arma.,1,0.720023324,10,7,3,1,1,7,7,0,Gli studi hanno dimostrato che oltre il 85% degli intervistati ha sostenuto i controlli di fondo nazionali nei registri di salute mentale dei cittadini che tentavano di acquistare una pistola.,1,0.632897187,10,6,4,1,1,6,6,0
We should increase the use of part-time contracts,Dovremmo aumentare l'utilizzo dei contratti a tempo parziale,"David Blanchflower is the Bruce V Rauner professor of economics at Dartmouth College, New Hampshire, part-time professor at the University of Stirling, a research associate at the National Bureau of Economic Research, and a contributing editor for Bloomberg TV.",0,0,0,"David Blanchflower e' professore di economia Bruce V Rauner al college Dartmouth, New Hampshire, professore a mezza giornata alla universita' di Stirling, ricercatore associato al National Bureau of Economic Research, e collaboratore a Bloomberg TV.",0,1,7,0,7,,,0,0,0,"David Blanchflower è il Bruce V Rauner professore di Economia al Dartmouth College, New Hampshire, professore part-time all'Università di Stirling, un socio di ricerca presso il National Bureau of Economic Research, e un editor contributore per Bloomberg TV.",0,1,8,0,8,,,0,0,0
We should increase the use of part-time contracts,Dovremmo aumentare l'utilizzo dei contratti a tempo parziale,He also began part-time work as a dentist.,0,0.1,0,Ha anche iniziato a lavorare part-time come dentista.,0,0.79073548,10,2,8,1,1,2,2,0,Ha anche iniziato il part-time come dentista.,0,0.897707378,10,1,9,1,1,1,1,0
We should increase the use of probation,Dovremmo aumentare l'uso della libertà vigilata,I think this is a clear case of someone using a sock to get around an ArbCom ban on a page that is currently on probation to protect it from exactly this kind of thing.,0,0.1,0,Penso che questo sia un chiaro caso di qualcuno che usa un calzino per aggirare un divieto dell'ArbCom su una pagina che è attualmente sotto osservazione per proteggerla proprio da questo genere di cose.,0,1,7,0,7,,,0,0,0,Penso che questo sia un caso evidente di qualcuno che usa un calzino per aggirarsi su un divieto di ArbCom su una pagina che è attualmente in libertà vigilata per proteggerla da esattamente questo genere di cose.,0,1,9,0,9,,,0,0,0
We should increase the use of probation,Dovremmo aumentare l'uso della libertà vigilata,"After a meeting with the head of the university's campus security service, the ban was reduced to probation.  ",0,0.1,0,"dopo una riunione con il capo della sicurezza della citta' universitaria, il divieto e' stato ridotto a liberta vigilate.",0,1,7,0,7,,,0,0,0,"Dopo un incontro con il capo del servizio di sicurezza del campus universitario, il divieto è stato ridotto alla libertà vigilata.  ",0,1,7,0,7,,,0,0,0
We should increase the use of public spaces,Dovremmo aumentare l'uso degli spazi pubblici,"A supporter of the ""Save Kesey Square"" Facebook page expressed the sentiment, ""Public space creates and increases consciousness about what we can create and what we can imagine."" .  ",1,1,1,"Un sostenitore della pagina Facebook ""Save Kesey Square"" ha espresso l'opinione ""Lo spazio pubblico crea e aumenta la consapevolezza di ciò che possiamo creare e di ciò che possiamo immaginare"".",1,0.904369698,10,9,1,1,1,9,9,0,"Un sostenitore della pagina Facebook di ""Save Kesey Square"" ha espresso il sentimento, ""Spazio pubblico crea e aumenta la coscienza su ciò che possiamo creare e quello che possiamo immaginare"".  ",1,0.876880692,10,9,1,1,1,9,9,0
We should increase the use of public spaces,Dovremmo aumentare l'uso degli spazi pubblici,"""We believe that Montanans, the American public, and people everywhere value access to open spaces where plants and animals thrive in their natural environment.",1,1,1,"crediamo che i Montanani, il pubblico americano e tutte le persone ovunque siano apprezzino l'accesso agli spazi aperti dove piante e animali prosperano nel loro ambiente naturale.",1,0.816779286,10,8,2,1,1,8,8,0,""" Crediamo che Montanani, il pubblico americano, e le persone ovunque valorizzino l'accesso agli spazi aperti dove piante e animali prosperano nel loro ambiente naturale.",1,1,7,7,0,1,1,7,7,0
We should increase the use of rapid transit,Dovremmo aumentare l'uso del transito rapido,The unprecedented growth which characterized the Los Angeles region in the postwar years ultimately led to the closure of the Subway in the 1950s.,0,0.1,0,La crescita senza precedenti che ha caratterizzato la regione di Los Angeles nel dopoguerra ha portato alla chiusura della metropolitana negli anni Cinquanta.,0,0.924096481,10,1,9,,,1,1,0,La crescita senza precedenti che ha caratterizzato la regione di Los Angeles negli anni del dopoguerra ha infine portato alla chiusura della Subway negli anni ' 1950s.,0,0.758393752,10,3,7,,,3,2,1
We should increase the use of rapid transit,Dovremmo aumentare l'uso del transito rapido,"The SociÃ©tÃ© de transport de MontrÃ©al (STM) () is a public transport agency that operates transit bus, and rapid transit services in Montreal, Quebec, Canada.",0,0.090909091,0,"la Societa' dei Trasporti dI MontrEal (STM) e' una agenzia di trasporti pubblica che opera autobus e servizi di transito rapido in Montreal, Quebec, Canada.",0,0.825301012,10,2,8,1,1,2,2,0,"La Société de transport de Montréal (STM) () è un'agenzia di trasporto pubblico che gestisce autobus di transito, e servizi di transito rapido a Montreal, Quebec, Canada.",0,1,7,0,7,,,0,0,0
We should increase the use of scholarships,Dovremmo aumentare l'utilizzo delle borse di studio,"$100,000 to the University of Southern California, for ""scholarships for poor students.""",1,0.636363636,1,"100.000 dollari all'Università della California del Sud, per ""borse di studio agli studenti poveri"".",1,0.536120133,10,5,5,1,1,5,5,0,"$100.000 alla University of Southern California, per ""borse di studio per studenti poveri"".",0,0.628930605,10,4,6,1,1,4,4,0
We should increase the use of scholarships,Dovremmo aumentare l'utilizzo delle borse di studio,"On 10 September 1998, in a press release, the minister stated: The scholarships are probably unconstitutional due to the limitation in section 51 preventing civil conscription of doctors."" .",1,1,-1,"il 10 settembre 1998, in un comunicato stampa, il ministro dichiaro': le borse di studio sono probabilmente inconstuzionali per via della limitazione della sezione 51 che impedisce il reclutamento civile dei medici",1,1,7,7,0,-1,1,7,0,7,"Il 10 settembre 1998, in un comunicato stampa, il ministro ha dichiarato: Le borse di studio sono probabilmente incostituzionali a causa della limitazione nella sezione 51 che impedisce la coscrizione civile dei medici "".",1,1,8,8,0,-1,1,8,0,8
We should increase the use of telemedicine,Dovremmo aumentare l'uso della telemedicina,"The medical institutions of the Plaza de la Salud: the General Hospital (HGPS) and the Centers for Diagnostics and Advanced Medicine and Medical Conferences and Telemedicine (CEDIMAT), part of the concept created by Dr. Juan Manuel Taveras Rodriguez, a world-renowned Dominican medical specialist, considered the father of Neuroradiology.",0,0.2,0,"le istituzioni mediche di Plaza de la Salud: l'ospedale generale (HGPS) e i centri diagnostici e medicine avanzate e conferenze mediche e telemedicine (CEDIMAT) parte del concetto creato dal dott Juan Manuel Taveras Rodriguez, un medico specialista Domenicano famoso in tutto il mondo, considerato il padre della neuroradiologia.",0,0.934586211,10,1,9,,,1,1,0,"Le istituzioni mediche del Plaza de la Salud: l'Ospedale Generale (HGPS) e i Centri per la diagnostica e le Conferenze Mediche e le Conferenze Mediche e la telemedicina (CEDIMAT), parte del concetto creato dal dottor Juan Manuel Taveras Rodriguez, specialista medico domenicano, considerato il padre di Neuroradiologia.",0,1,7,0,7,,,0,0,0
We should increase the use of telemedicine,Dovremmo aumentare l'uso della telemedicina,He is a strong advocate of telemedicine as a means to reduce the costs of treating patients .,1,0.6,1,È un forte sostenitore della telemedicina come mezzo per ridurre i costi di trattamento dei pazienti.,1,0.788467046,10,7,3,1,1,7,7,0,È un forte sostenitore della telemedicina come mezzo per ridurre i costi di trattamento dei pazienti.,1,0.805727906,13,11,2,1,1,11,11,0
We should increase the workweek,Dovremmo aumentare la settimana di lavoro,"Megabus worked okay, willing to try it again, but not sure if that weekend is good.",0,0,0,"Megabus ha funzionato bene ed è disposto a riprovarci, ma non sono sicuro che quel fine settimana vada bene.",0,0.888578376,10,1,9,1,1,1,1,0,"Megabus ha lavorato bene, disposto a riprovarci, ma non certo se quel fine settimana è buono.",0,0.897707378,10,1,9,1,1,1,1,0
We should increase the workweek,Dovremmo aumentare la settimana di lavoro,Some governments create tax-free weekends as incentives for business investment.,0,0,0,alcuni governi creano fine settimana senza tasse come incentivi per investimenti commerciali,0,0.56886974,10,4,6,1,1,4,4,0,Alcuni governi creano weekend esentasse come incentivi per gli investimenti delle imprese.,0,0.816474946,10,2,8,1,1,2,2,0
We should increase trade barriers,Dovremmo aumentare le barriere commerciali,From October 1994 until September 1999 he was the Chief of the Northwestern Center of the Federal Directorate for Currency and Export Control of Russia.,0,0,0,Dall'ottobre 1994 al settembre 1999 è stato il capo del Centro nord-occidentale della Direzione federale per il controllo delle valute e delle esportazioni della Russia.,0,0.920782499,10,1,9,,,1,1,0,Da ottobre 1994 fino a settembre 1999 è stato Capo del Centro Northwestern della Direzione federale per la valuta e il controllo delle esportazioni della Russia.,0,1,7,0,7,,,0,0,0
We should increase trade barriers,Dovremmo aumentare le barriere commerciali,"Be a producer or exporter of arms or sensitive industrial equipment  Maintain non-proliferation policies and appropriate national policies, including adherence to: Non-proliferation policies, such as (where applicable) the Nuclear Suppliers Group, the Missile Technology Control Regime, and the Australia Group Nuclear Non-Proliferation Treaty, the Biological Weapons Convention, the Chemical Weapons Convention and, where applicable, START I (including the Lisbon Protocol)  Maintain fully effective export controls .  ",0,0.1,0,"essere un produttore o esportatore di armi o apparecchiature industriali sensibili mantiene politiche di non proliferazione e giuste politiche nazionali, come l'adesione a: politiche di non proliferazione, come (dove applicabile) il Gruppo di Fornitori Nucleari, il Regime di Controllo della Tecnologia Missilistica, e il Trattato di Non Proliferzione Nucleare del Gruppo Australiano, la Convenzione di Armi Biologiche, la Convenzione di Armi Chimiche e, dove applicabile, START (compreso il Protocollo di Lisbona) mantiene il pieno controllo effetivo delle esportazioni.",0,1,7,0,7,,,0,0,0,"Essere produttore o esportatore di armi o di attrezzature industriali sensibili Mantenere politiche di non proliferazione e politiche nazionali appropriate, compresa l'aderenza a: Politiche di non proliferazione, quali (se del caso) il Nuclear Suppliers Group, il Regime di controllo della tecnologia Missile, e il trattato di non proliferazione nucleare del gruppo Australia, la Convenzione sulle armi biologiche, la Convenzione sulle armi chimiche e, ove applicabile, START I (compreso il protocollo di Lisbona) Mantenere un'esportazione pienamente efficace controlli.  ",0,1,7,0,7,,,0,0,0
We should introduce a national identity card,Dovremmo introdurre una carta d'identità nazionale,"Electoral Commission Chairman Graeme Leung had announced in late November 2005 that identity cards for voters were being prepared, to discourage voter impersonation.",0,0.5,1,"Il presidente della Commissione elettorale Graeme Leung aveva annunciato alla fine di novembre 2005 che si stavano preparando le carte d'identità per gli elettori, per scoraggiare l'uso di false informazioni personali .",1,0.550356902,10,6,4,1,1,6,6,0,"Il presidente della Commissione elettorale Graeme Leung aveva annunciato a fine novembre 2005 che le carte d'identità per gli elettori venivano preparate, per scoraggiare l'imitazione dei votanti.",0,0.615478726,10,4,6,1,1,4,4,0
We should introduce a national identity card,Dovremmo introdurre una carta d'identità nazionale,A Department of Health and Human Services identification card is needed for immediate access.,0,0.222222222,0,un documento di identificazione del dipartimento di salute e servizi umani e' richiesto per l'accesso immediato.,0,0.93485865,10,1,9,,,1,1,0,Per un accesso immediato è necessaria una scheda di identificazione del Dipartimento di Salute e Human Services.,0,0.900315772,10,1,9,,,1,1,0
We should introduce guaranteed minimum income,Dovremmo introdurre un reddito minimo garantito,"In 1973, Daniel Patrick Moynihan wrote The Politics of a Guaranteed Income, in which he advocated the guaranteed minimum income and discussed Richard Nixon's Guaranteed Annual Income (GAI) proposal .  ",1,0.7,1,"Nel 1973, Daniel Patrick Moynihan scrisse The Politics of a Guaranteed Income (La politica di un reddito garantito), in cui sosteneva il reddito minimo garantito e discuteva la proposta di Richard Nixon sul reddito annuo garantito (GAI).",1,1,7,7,0,1,1,7,7,0,"Nel 1973, Daniel Patrick Moynihan scrisse The Politics of a Garantiti Income, in cui sosteneva il reddito minimo garantito e discusse la proposta di Richard Nixon's Garantiti Annual Income (GAI).  ",1,0.875417985,10,8,2,1,1,8,8,0
We should introduce guaranteed minimum income,Dovremmo introdurre un reddito minimo garantito,"In July 2013, the Cypriot government unveiled a plan to reform the welfare system in Cyprus and create a Guaranteed Minimum Income for all citizens.",1,1,1,nel luglio 2013 il governo Cipriota rivelo' un piano per riformare il sistema di benessere pubblico a Cipro e creare un Reddito Minimo Garantito per tutti i cittadini.,1,1,7,7,0,1,1,7,7,0,A luglio 2013 il governo cipriota ha svelato un piano per riformare il sistema di welfare a Cipro e creare un reddito minimo garantito per tutti i cittadini.,1,1,8,8,0,1,1,8,8,0
We should introduce the alternative vote,Dovremmo introdurre il voto alternativo,"On 11 March, 29 historians, including Niall Ferguson, Simon Sebag Montefiore, Andrew Roberts and David Starkey, wrote to the Times expressing opposition to the adoption of the Alternative Vote.",1,0.7,-1,"L'11 marzo, 29 storici tra i quali Niall Ferguson, Simon Sebag Montefiore, Andrew Roberts e David Starkey, hanno scritto al Times esprimendo la loro opposizione all'adozione del Voto Alternativo.",1,1,7,7,0,-1,1,7,0,7,"Il 11 marzo, 29 storici, tra cui Niall Ferguson, Simon Sebag Montefiore, Andrew Roberts e David Starkey, hanno scritto al Times esprimere opposizione all'adozione del Voto Alternativo.",1,0.787695768,10,8,2,-1,1,8,0,8
We should introduce the alternative vote,Dovremmo introdurre il voto alternativo,"In the United Kingdom, a 2011 referendum on adopting Instant-runoff voting saw the proposal rejected.  ",1,0.8,-1,"nel regno Unito, un referendum del 2011 sull'adozione del deflusso istantaneo vide la proposta rifiutata",0,0.91232488,10,1,9,,,1,0,1,"Nel Regno Unito, un referendum del 2011 sull'adozione del voto di Instant ha visto la proposta respinta.  ",1,0.58842964,10,6,4,-1,1,6,0,6
We should legalize LGBT adoption,Dovremmo legalizzare l'adozione LGBT,Chile: A January 2017 nationwide poll found that 45% of Chileans support same-sex adoption.,1,0.9,1,Cile: nel gennaio 2017 un referendum nazionale ha riscontrato che il 45% dei cileni condivide l'adozione delle coppie dello stesso sesso,1,0.904821088,10,9,1,1,1,9,9,0,Cile: un sondaggio nazionale di gennaio 2017 ha scoperto che il 45% dei cileni sostiene l'adozione dello stesso sesso.,1,1,7,7,0,1,1,7,7,0
We should legalize LGBT adoption,Dovremmo legalizzare l'adozione LGBT,Justice Minister Nikos Paraskevopoulos announced that same-sex adoption will be studied in the future .,0,0.2,0,Il Ministro della Giustizia Nikos Paraskevopoulos ha annunciato si studierà l'adozione da parte di persone dello stesso sesso.,0,0.561064723,10,5,5,1,1,5,5,0,Il ministro della Giustizia Nikos Paraskevopoulos ha annunciato che l'adozione dello stesso sesso sarà studiata in futuro.,1,0.54287647,10,6,4,1,1,6,6,0
We should limit Hydrocarbon exploration,Dovremmo limitare l'esplorazione degli idrocarburi,Both Kean and Menendez oppose ANWR oil exploration.,1,0.9,1,"Sia Kean che Menendez si oppongono all'esplorazione petrolifera dell'ANWR, l'Arctic National Wildlife Refuge.",1,1,7,7,0,1,1,7,7,0,Sia Kean che Menendez si oppongono all'esplorazione petrolifera ANWR.,0,0.546265855,11,5,6,1,1,5,5,0
We should limit Hydrocarbon exploration,Dovremmo limitare l'esplorazione degli idrocarburi,Human activities such as transportation development and petroleum exploration has led to the population decline of the species.,1,1,1,attivita' umane come lo sviluppo dei trasporti e l'esplorazione di petrolio ha portato al declino della popolazione della specie,1,0.523195222,10,6,4,1,1,6,6,0,Le attività umane come lo sviluppo del trasporto e l'esplorazione petrolifera hanno portato al declino della popolazione della specie.,1,0.870918176,10,9,1,1,1,9,7,2
We should limit campaign finance,Dovremmo limitare la finanza di campagna,"In late June, however, the New York Post reported that he had accepted a campaign contribution from a taxi manufacturer whose handicapped-accessible vehicle was being considered for adoption by New York's Taxi and Limousine Commission .  ",0,0.1,0,"Alla fine di giugno, tuttavia, il New York Post ha riferito di aver accettato un contributo per la campagna di un produttore di taxi il cui veicolo, accessibile ai disabili, è stato preso in considerazione per l'adozione da parte della Taxi and Limousine Commission di New York.  ",0,0.674304632,10,4,6,-1,1,4,1,3,"A fine giugno, però, il New York Post ha riferito di aver accettato un contributo di campagna da parte di un costruttore di taxi il cui veicolo handicappato è stato considerato per adozione dalla Commissione Taxi e Limousine di New York.  ",0,0.942987827,10,1,9,,,1,1,0
We should limit campaign finance,Dovremmo limitare la finanza di campagna,"Buckley v. Valeo, 424 U.S. 1 (1976) upheld limits on campaign contributions, but held that spending money to influence elections is protected speech by the First Amendment.",1,0.8,1,"Buckley v. Valeo, 424 U.S. 1 (1976) sosteneva limiti ai contributi alle campagne, ma sosteneva che spendere denaro per influenzare le elezioni e' protetto dal Primo Emendamento.",1,0.837875876,10,8,2,1,1,8,8,0,"Buckley v. Valeo, 424 Usa 1 (1976) ha mantenuto dei limiti sui contributi della campagna, ma ha ritenuto che spendere soldi per influenzare le elezioni sia protetto discorso dal Primo emendamento.",1,0.915883873,10,9,1,1,1,9,6,3
We should limit judicial activism,Dovremmo limitare l'attivismo giudiziario,"The research unit focuses on the proper scope of judicial power within the Westminster constitution, arguing that judicial overreach increasingly threatens the rule of law and effective, democratic government.",1,1,1,"L'unità di ricerca si concentra sulla corretta portata del potere giudiziario all'interno della costituzione di Westminster, sostenendo che il suo eccesso minaccia sempre più lo stato di diritto e un governo efficace e democratico.",1,0.745893608,11,9,2,1,1,9,9,0,"L'unità di ricerca si concentra sulla corretta portata del potere giudiziario all'interno della costituzione di Westminster, sostenendo che la sorretta giudiziaria minaccia sempre di più lo Stato di diritto e il governo democratico efficace.",0,0.524341282,10,5,5,1,1,5,5,0
We should limit judicial activism,Dovremmo limitare l'attivismo giudiziario,"In addition it encourages democratic accountability and judicial responsibility, while discouraging unjust judicial activism and the undue legalization of the public realm.",0,0,0,"in aggiunta incoraggia la responsabilita' democratica e quella giudiziaria, mentre scoraggia l'attivismo giudiziale ingiusto e la legazzizione del regno pubblico",0,0.569601456,10,5,5,,,5,5,0,"Inoltre incoraggia la responsabilità democratica e la responsabilità giudiziaria, scoraggiando l'attivismo giudiziario ingiusto e l'indebita legalizzazione del regno pubblico.",1,0.504313513,10,5,5,1,1,5,4,1
We should limit judicial review,Dovremmo limitare la revisione giudiziaria,"The commission, however, was stopped almost immediately as police commissioner Joshua Bong sought a judicial review of it.",0,0,0,"La commissione, tuttavia, è stata fermata quasi immediatamente, poiché il commissario di polizia Joshua Bong ha chiesto un controllo giudiziario.",0,0.912898263,10,1,9,,,1,0,1,"La commissione, però, è stata fermata quasi subito come il commissario di polizia Joshua Bong ha cercato una revisione giudiziaria.",0,1,7,0,7,,,0,0,0
We should limit judicial review,Dovremmo limitare la revisione giudiziaria,"The landmark case was described by law professor Marci Hamilton as a ""fork in the road"" with respect to judicial review of the Establishment Clause of the First Amendment.",0,0,0,il caso di riferimento fu descritto dal professore di legge Marci Hamilton come un bivio sulla revisione giudiziaria della clausola di stabilimento del Primo emendamento.,0,0.91232488,10,1,9,,,1,1,0,"Il caso del landmark è stato descritto dal professore di diritto Marci Hamilton come ""forchetta in strada"" rispetto alla revisione giudiziaria della clausola di costituzione del Primo emendamento.",0,1,7,0,7,,,0,0,0
We should limit the use of appeals,Dovremmo limitare l'uso dei ricorsi,"In 2017, a coalition of attorneys general for several states, farm workers, and environmental groups sued then-EPA chief Scott Pruitt over his chlorpyrifos ban reversal.",0,0,0,"Nel 2017, una coalizione di procuratori generali di diversi stati, lavoratori agricoli e gruppi ambientalisti ha citato in giudizio l'allora capo dell'EPA Scott Pruitt per il ribaltamento del divieto di utilizzo del clorpirifos.",0,0.912898263,10,1,9,,,1,0,1,"Nel 2017 una coalizione di avvocati generali per diversi Stati, lavoratori agricoli e gruppi ambientalisti ha citato in giudizio il capo dell'EPA Scott Pruitt sul suo inverosimile al divieto di clorpirifos.",0,0.883648833,10,1,9,1,1,1,1,0
We should limit the use of appeals,Dovremmo limitare l'uso dei ricorsi,"On 2 June 2009, The Land and Environment Court passed down the decision to reject the appeal by the Quranic Society, with the court stating that the ""development application was not suitable for the rural nature of the land."" .",0,0.3,0,"il 2 giugno 2009, il Tribunale per la Terra e l'Ambiente ha approvato la decisione di respingere l' appello di Quaranic Society, con la dichiarazione della corte che ""l'applicazione non era adatta per la natura rurale della terra"".",0,0.567066632,10,4,6,1,1,4,4,0,"Il 02 giugno 2009, la Corte Land and Ambiente ha approvato la decisione di respingere l'appello della Società Quranica, con il tribunale affermando che la ""domanda di sviluppo non era adatta alla natura rurale della terra"".",0,0.786802049,10,2,8,1,1,2,2,0
We should limit the use of petroleum,Dovremmo limitare l'uso del petrolio,"In 2002, Guru Govind Singh Refineries Ltd. signed an agreement with the Port of Mundra to handle crude oil in the port.",0,0,0,"Nel 2002, la Srl Guru Govind Singh Refineries ha firmato un accordo con il porto di Mundra per la movimentazione del greggio nel porto.",0,0.872064787,10,1,9,-1,1,1,0,1,"Nel 2002, Guru Govind Singh Refineries Ltd. ha firmato un accordo con il Porto di Mundra per movimentare il greggio nel porto.",0,0.89533277,10,1,9,,,1,0,1
We should limit the use of petroleum,Dovremmo limitare l'uso del petrolio,"Biodiesel is a renewable, clean burning diesel replacement that reduces U.S. dependence on foreign petroleum, creating jobs and improving the environment.",1,0.7,1,"il biodiesel e' un sostitutivo al diesel, pulito e rinnovabile che ridurrebe la dipendenza americana al petrolio estero, creando posti di lavoro e migliorando l'ambiente.",1,0.90545351,10,9,1,1,1,9,9,0,"Il biodiesel è una sostituzione diesel a combustione pulita e pulita che riduce la dipendenza Usa dal petrolio straniero, creando posti di lavoro e migliorando l'ambiente.",1,0.893466079,10,9,1,1,1,9,9,0
We should nationalize the health care industry,Dovremmo nazionalizzare l'industria sanitaria,The Centre is committed to supporting thought leadership in the health sector industry.,0,0,0,Il Centro è impegnato a sostenere la leadership di pensiero nel settore sanitario.,0,0.893552228,10,1,9,,,1,1,0,Il Centro è impegnato a sostenere la leadership del pensiero nell'industria del settore sanitario.,0,0.876880692,10,1,9,1,1,1,1,0
We should nationalize the health care industry,Dovremmo nazionalizzare l'industria sanitaria,"A watchdog group found that in July 2009 Baucus accepted additional money from the health care industry in violation of his own self-defined moratorium terms, reportedly leading Baucus to return those monies.",0,0,0,"un gruppo di guardiani scopri' che nel luglio 2009 Baucus accetto' denaro dall' industria sanitaria in violazione dei suoi stessi termini di moratoria, portando Baucus a restituire quel denaro.",0,0.93485865,10,1,9,,,1,1,0,"Un gruppo di watchdog ha scoperto che nel luglio 2009 Baucus ha accettato ulteriori soldi dall'industria sanitaria in violazione dei propri termini morosi autodefiniti, riportando Baucus a restituire quei mondi.",0,1,7,0,7,,,0,0,0
We should not abandon the Paris Agreement,Non dovremmo abbandonare l'accordo di Parigi,"Facebook's Mark Zuckerberg said ""Withdrawing from the Paris climate agreement is bad for the environment, bad for the economy, and it puts our children's future at risk."" .",1,1,1,"Mark Zuckerberg di Facebook ha dichiarato: ""Il ritiro dall'accordo di Parigi sul clima è un male per l'ambiente, un male per l'economia, e mette a rischio il futuro dei nostri figli"".",1,1,10,10,0,-1,1,10,9,1,"Il Mark Zuckerberg di Facebook ha detto che ""Withdisegnare dall'accordo sul clima di Parigi fa male all'ambiente, male per l'economia, e mette a rischio il futuro dei nostri figli"".",1,0.803397008,10,8,2,-1,0.551735345,8,5,3
We should not abandon the Paris Agreement,Non dovremmo abbandonare l'accordo di Parigi,"On June 1, 2017, Donald Trump announced that the United States would withdraw from the Paris Agreement on climate change.",1,0.9,-1,"il 1 luglio 2017, Donald Trump annuncio' che gli Stati Uniti si sarebbero ritirati dall'accordo di Parigi sui cambiamenti climatici.",1,0.811064779,10,8,2,-1,1,8,0,8,Il 01 giugno 2017 Donald Trump ha annunciato che gli Stati Uniti si ritireranno dall'accordo di Parigi sul cambiamento climatico.,1,0.625966492,10,6,4,1,0.551735345,6,1,5
We should prohibit carrying a concealed weapon,Dovremmo proibire di trasportare un'arma occulta,"In 2017, Isakson stated that while he does support concealed carry nationwide, he does not support campus carry, stating that it is ""not the appropriate thing to do."" .  ",0,0.2,0,"Nel 2017, Isakson ha dichiarato che mentre sostiene il trasporto nascosto a livello nazionale, non sostiene quello nel campus, affermando che ""non è la cosa giusta da fare""...",0,1,7,0,7,,,0,0,0,"Nel 2017, Isakson ha dichiarato che mentre sostiene il sostegno occulto a portata nazionale, non sostiene il campus, affermando che non è ""la cosa giusta da fare"".  ",0,1,7,0,7,,,0,0,0
We should prohibit carrying a concealed weapon,Dovremmo proibire di trasportare un'arma occulta,Does this Arkansas state law that made illegal the carrying of a concealed weapon infringe on citizens Second Amendment rights? .,0,0.1,0,e' questa legge dell' Arkansas che ha reso illegale il posseso di armi nascoste viola il Secondo Emendamento sui i diritti dei cittadini?,0,0.742018915,10,3,7,-1,1,3,2,1,Questa legge dello stato dell'Arkansas che ha reso illegale la realizzazione di un'arma occultata viola i cittadini Secondo i diritti di secondo emendamento?.,0,0.61711463,10,4,6,-1,1,4,0,4
We should prohibit over the counter drugs,Dovremmo vietare i farmaci contro la droga,We conclude over-the-counter derivatives contributed significantly to this crisis.,0,0.5,1,Concludiamo che i derivati over-the-counter hanno contribuito in modo significativo a questa crisi.,0,0.882458201,10,1,9,,,1,1,0,Concludiamo che i derivati over-the-counter hanno contribuito in modo significativo a questa crisi.,0,0.633383972,10,3,7,-1,0.528995613,3,2,1
We should prohibit over the counter drugs,Dovremmo vietare i farmaci contro la droga,"While other IRS-approved ""auto-adjudication"" systems for electronic substantiation of FSA debit card charges are geared towards health plan expenses, such as copay matching or electronic transmittal of explanations of benefits, IIAS is the only one that is designed for use with over-the-counter drugs and similar items (OTC) as well as prescription drugs.",0,0,0,"mentre altri sistemi di ""auto-aggiudicazione"" approvati dall' IRS per la convalida dei costi delle carte di debito FSA sono portati verso le spese del piano sanitario, come il corrispettivo copay o la trasmissione elettronica delle spiegazioni dei benefici, IIAS e' l'unico progettato per l'utilizzo dei farmaci senza ricetta e prodotti simili (OTC) come pure medicinali con ricetta.",0,1,7,0,7,,,0,0,0,"Mentre altri sistemi di ""auto-adgiudiziation"" approvati dall'IRS per la convalida elettronica delle tariffe delle carte di debito FSA sono orientati verso le spese per il piano sanitario, come il matching di copay o la trasmittanza elettronica delle spiegazioni dei benefici, l'IIAS è l'unico progettato per l'utilizzo con farmaci over-the-counter e articoli simili (OTC) oltre a farmaci da prescrizione.",0,0.900315772,10,1,9,,,1,0,1
We should prohibit school prayer,Dovremmo proibire la preghiera scolastica,Prayer in public schools was banned in the late 1980s by a decision of the Ontario Court of Appeal .  ,1,1,1,La preghiera nelle scuole pubbliche è stata vietata alla fine degli anni '80 da una decisione della Corte d'appello dell'Ontario.,1,0.689780026,10,8,2,1,1,8,8,0,La preghiera nelle scuole pubbliche è stata vietata alla fine degli anni ' 1980s con una decisione della Corte d'Appello dell'Ontario.  ,1,0.813487358,12,10,2,1,1,10,10,0
We should prohibit school prayer,Dovremmo proibire la preghiera scolastica,"He voted in favor of school prayer, capping punitive damage awards, amending the U.S. Constitution to require a balanced budget, and limiting death penalty appeals.",0,0.3,-1,"ha votato in favore di preghiere scolastiche, trattenendo premi punitivi, modificando la costituzione americana per richiedere un budget bilanciato, e limitando gli appelli alla pena di morte.",1,0.90545351,10,9,1,-1,1,9,0,9,"Ha votato a favore della preghiera scolastica, capendo premi punitivi di danno, che modifica la Costituzione Usa per richiedere un bilancio equilibrato, e limitare i ricorsi di pena di morte.",1,0.753061945,10,7,3,-1,1,7,1,6
We should prohibit subprime lending,Dovremmo proibire i prestiti subprime,A group of more than 3500 students and former students called the ITT Tech Warriors have protested that they received a subprime education and called for debt forgiveness .  ,0,0,0,Un gruppo di più di 3500 studenti ed ex studenti chiamati ITT Tech Warriors hanno protestato per aver ricevuto un'istruzione con il ricorso ai prestiti subprime e hanno richiesto il condono del debito.,0,0.509821053,10,5,5,1,1,5,5,0,Un gruppo di oltre 3500 studenti ed ex studenti chiamati ITT Tech Warriors hanno protestato per aver ricevuto un'istruzione di subprime e ha chiesto il perdono del debito.  ,0,0.558138823,10,4,6,1,1,4,4,0
We should prohibit subprime lending,Dovremmo proibire i prestiti subprime,"Therefore, a high ownership ratio combined with an increased rate of subprime lending may signal higher debt levels associated with bubbles.",1,0.833333333,1,"pertanto, un alto indice di proprieta' combinato ad un aumento del tasso dei prestiti subprime associati a bolle.puo' segnalare livelli di debito maggiori",1,0.530321751,10,5,5,1,1,5,5,0,"Pertanto, un elevato rapporto di proprietà combinato con un aumentato tasso di prestiti subprime può segnalare livelli di debito più elevati associati a bolle.",1,0.659247466,10,6,4,1,1,6,6,0
We should protect animal welfare,Dovremmo proteggere il benessere animale,"Glimcher said that the decision was made before her term on the board and said: ""As a scientist, I strongly support the ethical and humane treatment of animals used in research...",1,0.9,1,"Glimcher ha detto che la decisione è stata presa prima del suo mandato nel consiglio di amministrazione e ha dichiarato: ""Come scienziato, sostengo fortemente il trattamento etico e umano degli animali usati nella ricerca...",1,1,7,7,0,1,1,7,7,0,"Glimcher ha detto che la decisione è stata presa prima del suo mandato sul tabellone e ha detto: "" Come scienziato, sostengo fortemente il trattamento etico e umano degli animali utilizzati nella ricerca ...",1,1,7,7,0,1,1,7,7,0
We should protect animal welfare,Dovremmo proteggere il benessere animale,Tong is an advocate for animal welfare and environmental conservation.,1,0.9,1,Tong e' un sostenitore del benessere degli animali e della conservazione ambientale.,1,0.632480421,10,7,3,1,1,7,7,0,Tong è un sostenitore del benessere animale e della conservazione ambientale.,1,0.634946049,10,7,3,1,1,7,7,0
We should protect freedom of religion,Dovremmo proteggere la libertà di religione,"The latter stance was taken in a U.S. presidential executive order issued in May 2017 in which President Trump held that ""the United States Constitution enshrines and protects the fundamental right to religious liberty as Americans' first freedom.""",1,1,1,"Quest'ultima posizione è stata presa in un ordine esecutivo presidenziale statunitense emesso nel maggio 2017, in cui il presidente Trump ha affermato che ""la Costituzione degli Stati Uniti sancisce e protegge il diritto fondamentale alla libertà religiosa come prima libertà degli americani"".",1,1,7,7,0,1,1,7,7,0,"Quest' ultima presa di posizione è stata presa in un ordine esecutivo presidenziale statunitense emesso nel maggio 2017 in cui il presidente Trump ha ritenuto che ""la Costituzione degli Stati Uniti sancisce e protegge il diritto fondamentale alla libertà religiosa come prima libertà degli americani"".",1,1,9,9,0,1,1,9,9,0
We should protect freedom of religion,Dovremmo proteggere la libertà di religione,Leaders of the French Protestant minority claim that freedom of religion was actually well protected in France and that cultural sensitivity and careful relationships with local authorities and other Christians could prevent most difficulties.  ,1,1,1,i capi della minoranza protestante francese affermano che la liberta' di religione era ben protetta effettivamente e che la sensibilita' culturale e la attenta relazione con le autorita' locali e altri cristiani avrebbero evitato molti problemi,1,0.90545351,10,9,1,1,1,9,9,0,I leader della minoranza protestante francese sostengono che la libertà di religione era in realtà ben protetta in Francia e che la sensibilità culturale e i rapporti attenti con le autorità locali e gli altri cristiani potevano prevenire la maggior parte delle difficoltà.  ,1,1,7,7,0,1,1,7,7,0
We should subsidize Anti-diabetic medication,Dovremmo sovvenzionare farmaci anti - diabetici,"In 1973 the firm developed process technology to make the anti-diabetic drug glibenclamide, while in 1977 the firm launched Dexona-20, which was a concentrated form of the anti-inflammatory drug dexamethasone.  ",0,0.166666667,0,"Nel 1973 l'azienda ha sviluppato una tecnologia di processo per creare il farmaco antidiabetico glibenclamide, mentre nel 1977 ha lanciato il Dexona-20 che era una forma concentrata del farmaco anti-infiammatorio desametasone.",0,0.813585493,10,2,8,1,1,2,2,0,"Nel 1973 l'azienda ha sviluppato la tecnologia di processo per rendere il farmaco anti - diabetico glibenclamide, mentre nel 1977 l'azienda ha lanciato Dexona-20, che era una forma concentrata del farmaco antinfiammatorio desametasone.  ",0,1,7,0,7,,,0,0,0
We should subsidize Anti-diabetic medication,Dovremmo sovvenzionare farmaci anti - diabetici,The Okinawan bitter melon is proven to have some anti-diabetic effects.,0,0,0,si e' dimostrato che il melone amaro di Okinawa ha alcuni effetti anti diabetici.,0,1,7,0,7,,,0,0,0,Il melone amaro di Okinawan è dimostrato avere alcuni effetti anti - diabetici.,0,1,7,0,7,,,0,0,0
We should subsidize adult learners,Dovremmo sovvenzionare gli allievi adulti,The Maimonides Schools for Jewish Studies offers classes in Jewish studies for adult learners in the Greater Toronto Area.,0,0.3,1,Le Maimonides Schools for Jewish Studies offrono corsi di studi ebraici per adulti della Greater Toronto Area.,0,0.834528919,10,2,8,,,2,2,0,La Maimonide Scuole per gli Studi ebraici offre lezioni di studi ebraici per gli allievi adulti nell'Area Maggiore di Toronto.,0,0.851689953,10,2,8,,,2,2,0
We should subsidize adult learners,Dovremmo sovvenzionare gli allievi adulti,"For example, Hansman shows how adult learners discover, shape, and make explicit their own knowledge through situated learning within a community of practice.",0,0.5,1,"per esempio, Hansman dimostra come studenti adulti scoprono, modellano e rendono esplicite le loro conoscenze attraverso apprendimento all'interno di una comunita' di pratica.",1,0.722417927,10,7,3,1,1,7,7,0,"Ad esempio, Hansman mostra come gli allievi adulti scoprono, plasmano e rendono espliciti le proprie conoscenze attraverso l'apprendimento situato all'interno di una comunità di pratica.",1,0.744076199,10,7,3,1,1,7,7,0
We should subsidize financial advisors,Dovremmo sovvenzionare i consulenti finanziari,It also provides back office support to financial advisors .  ,0,0,0,Fornisce anche supporto amministrativo ai consulenti finanziari.  ,0,0.716186726,10,3,7,1,1,3,3,0,Fornisce inoltre il supporto di back office ai consulenti finanziari.  ,0,0.947408195,10,1,9,,,1,1,0
We should subsidize financial advisors,Dovremmo sovvenzionare i consulenti finanziari,The National Society of Certified Healthcare Business Consultants (NSCHBC) is the largest professional society in the United States for persons and firms who provide practice management and financial consulting services to the healthcare industry.,0,0,0,la National Society of Certified Healthcare Business Consultants (NSCHBC) e' la piu' grande societa' professionale negli Stati Uniti per persone e aziende che offrono gestione pratica e consulenza finanziaria al settor sanitario,0,0.934586211,10,1,9,,,1,1,0,La National Society of Certified Healthcare Business Consulenti (NSCHBC) è la più grande società professionale degli Stati Uniti per le persone e le imprese che forniscono servizi di consulenza e consulenza finanziaria all'industria sanitaria.,0,1,7,0,7,,,0,0,0
We should subsidize medical schools,Dovremmo sovvenzionare le scuole mediche,"The study's authors argued that medical schools should encourage students to contribute to Wikipedia, both to improve the quality of its content and to enable students to become better health care educators .  ",0,0.2,0,"Gli autori dello studio hanno sostenuto che le scuole di medicina dovrebbero incoraggiare gli studenti a contribuire a Wikipedia, sia per migliorare la qualità dei suoi contenuti che per consentire agli studenti di diventare migliori educatori sanitari.",0,0.605437548,10,4,6,1,1,4,4,0,"Gli autori dello studio hanno sostenuto che le scuole mediche dovrebbero incoraggiare gli studenti a contribuire a Wikipedia, sia per migliorare la qualità dei suoi contenuti che per consentire agli studenti di diventare migliori educatori sanitari.  ",0,0.726566194,10,3,7,1,1,3,3,0
We should subsidize medical schools,Dovremmo sovvenzionare le scuole mediche,"There are 3 main health servicing buildings (Building 1, Queen Sirikit Building, and Somdech Phra Debaratana Building) on the medical school campus which serve at least 5,000 out-patient visits per day and in-patients with more than 1,000 beds for tertiary medical care.",0,0.181818182,0,"ci sono 3 edifici principali di servizi sanitari (Edificio 1, Queen Sirikit Building, e Somdech Phra Debaratana Building) nella scuola di medicina della citta' universitaria che aiuta almeno 5.000 di pazienti esterni al giorno e pazienti interni con piu' di 1.000 letti per cure mediche terziarie.",1,0.527479858,10,5,5,1,1,5,5,0,"Sono 3 i principali edifici sanitari (Building 1, Queen Sirikit Building e Somdech Phra Debaratana Building) sul campus della scuola medica che servono almeno 5.000 visite ambulatoriali al giorno e in - pazienti con più di 1.000 posti letto per cure mediche terziarie.",1,0.580300764,10,6,4,1,1,6,6,0
We should subsidize open access journals,Dovremmo sovvenzionare le riviste di accesso aperto,"In 2015, Alliance Rail Holdings, a company that formulates and implements open access rail proposals, was awarded the right to begin running six regular daily passenger services between Blackpool and London, to be operated by open access operator Grand Central using specially built EMUs.",0,0.176470588,1,"Nel 2015, Alliance Rail Holdings, una società che formula e implementa proposte ferroviarie ad accesso aperto, si è aggiudicata il diritto di avviare sei servizi passeggeri regolari giornalieri tra Blackpool e Londra. A gestirli sarà l'operatore di accesso aperto Grand Central utilizzando soprattutto EMU, Unità Multiple Elettriche, appositamente costruite.",0,1,7,0,7,,,0,0,0,"Nel 2015 Alliance Rail Holdings, azienda che formula e implementa le proposte ferroviarie di accesso aperto, è stato insignito del diritto di iniziare a gestire sei regolari servizi di passeggeri giornalieri tra Blackpool e Londra, per essere operato da operatore di accesso aperto Grand Central utilizzando EMU appositamente costruite.",0,1,8,0,8,,,0,0,0
We should subsidize open access journals,Dovremmo sovvenzionare le riviste di accesso aperto,"According to some views, ""ICTV should also promote the use of a public database to replace the ICTV database as a store of the primary metadata of individual viruses, and should publish abstracts of the ICTV Reports in that database, so that they are 'Open Access'."" .",1,0.571428571,1,secondo alcuni pareri ICTV dovrebbe promuovere l'uso di database pubblici per sostituire i database ICTV come storaggio di metadata primari di virus individuali e dovrebbe pubblicare parti di rapporti ICTV in quel databasetali da essere di pubblico dominio,0,1,7,0,7,,,0,0,0,"Secondo alcune opinioni, ""ICTV dovrebbe anche promuovere l'utilizzo di un database pubblico per sostituire il database di ICTV come archivio dei metadati primari dei singoli virus, e dovrebbe pubblicare abstract dei Report di ICTV in quel database, in modo che siano 'Open Access'."".",0,0.78294281,10,2,8,1,1,2,2,0
We should subsidize transportation network companies,Dovremmo sovvenzionare le aziende di rete di trasporto,"Only New York City and San Francisco have studied the vehicle miles traveled (VMT) implications of ridesourcing services, at present.",0,0,0,"Al momento, solo New York City e San Francisco hanno studiato le implicazioni dei servizi di ridesourcing in termini di chilometri percorsi dai veicoli.",0,0.911821606,10,1,9,,,1,1,0,"Solo New York City e San Francisco hanno studiato le implicazioni del raggio di viaggio (VMT) dei servizi di ridesourcing, attualmente.",0,1,9,0,9,,,0,0,0
We should subsidize transportation network companies,Dovremmo sovvenzionare le aziende di rete di trasporto,Estimates predict the $3.3 billion the ridesourcing sector made in 2015 will double to about a $6.5 billion market globally by 2020.,1,0.6,1,le stime prevedono che 3.3 miliardi del settore dei trasporti del 2015 raddoppira' di circa $6.5 miliardi globalmente del mercato,0,0.84718353,10,2,8,,,2,2,0,"Le stime prevedono i $3,3 miliardi di dollari il settore di ridesourcing realizzato nel 2015 raddoppierà a circa un mercato di $6,5 miliardi di dollari globalmente entro il 2020.",0,0.81892276,10,2,8,,,2,2,0
We should subsidize vocational education,Dovremmo sovvenzionare l'istruzione professionale,In 1887 the Committee of the Mechanics' Institute decided that the town's apprentices required technical instruction for the rapidly expanding engineering advances being made at the turn of the nineteenth century.,1,0.666666667,1,"Nel 1887 il Comitato dell'Istituto di Meccanica decise che gli apprendisti della città necessitavano di un'istruzione tecnica, alla luce dei progressi ingegneristici in rapida espansione a cavallo del XIX secolo.",1,0.515420465,10,6,4,-1,1,6,5,1,Nel 1887 il Comitato di Ingegneria Meccanica ha deciso che gli apprendisti della cittadina richiedegnano l'istruzione tecnica per i progressi di ingegneria in rapida espansione che si fanno al volgere dell'Ottocento.,0,1,7,0,7,,,0,0,0
We should subsidize vocational education,Dovremmo sovvenzionare l'istruzione professionale,"More specifically, his early work concentrated on the issue of accuracy and precision of databases as they are related to system development and maintenance, where the systems approach is done in terms of socially framed technical systems, conceived as a further development of the ""Berkeley school"" in the tradition of professor C. West Churchman.  ",0,0.1,0,"piu' specificamente, i suoi primi lavori concentrati sui problemi sull'accuratezza e precisione dei databasequando relativi ai sistemi di sviluppo e matenimento, dove l'approccio dei sistemi e' fatto in termini di sistemi tecnici socialmente strutturati, concepiti in un ulteriore sviluppo della "" Berkeley School"" nella tradizione del professor C. West Churchman.",0,1,7,0,7,,,0,0,0,"Più precisamente, i suoi primi lavori si sono concentrati sul tema dell'accuratezza e della precisione delle banche dati in quanto legati allo sviluppo e alla manutenzione del sistema, dove l'approccio dei sistemi avviene in termini di sistemi tecnici socialmente incorniciati, concepito come un ulteriore sviluppo della ""scuola di Berkeley"" nella tradizione del professore C. West Churchman.  ",0,1,7,0,7,,,0,0,0
